58 58 59 58 58 58 58 58 58 59 59 58 58 58 59 58 59 59 58 58 58 58 59 59 59 58 59 58 59 59 58 16 4 4 4 4 4 4 14 43 15 41 15 42 43 43 40 15 42 43 41 43 42 40 41 43 42 43 41 42 41 15 42 43 40 42 40 43 41 43 42 41 40 41 43 42 42 15 15 43 43 42 15 41 42 15 43 15 15 41 41 41 41 43 43 43 42 42 42 43
58 59 59 58 58 58 59 58 59 59 58 58 58 58 59 59 58 59 58 59 58 59 58 58 59 58 59 58 58 58 58 16 4 4 4 4 4 4 14 40 15 40 41 15 42 15 15 41 41 43 15 42 40 40 43 15 15 40 15 42 43 42 43 41 40 15 40 42 40 41 43 15 40 15 42 42 43 42 15 41 43 43 42 42 42 43 40 42 41 15 42 43 43 41 42 40 43 43 40 42
58 59 58 59 58 58 59 58 59 58 59 59 59 58 58 59 59 59 59 59 58 59 58 59 59 59 58 59 58 59 59 44 2 3 4 4 1 2 17 15 41 40 40 43 15 43 40 42 41 43 43 41 40 40 42 42 41 42 41 15 43 41 43 41 4 4 15 42 15 15 15 15 40 40 43 40 43 15 41 40 40 40 41 42 15 15 15 43 43 40 43 42 40 15 15 15 15 40 41 43
59 58 59 59 58 58 58 58 58 58 58 58 59 58 59 59 58 59 58 58 58 58 58 59 58 58 59 58 58 59 58 59 58 16 4 4 14 41 40 40 43 40 15 42 42 40 43 42 42 40 43 41 43 15 40 15 41 43 42 15 15 40 40 42 4 4 40 15 40 15 15 40 15 15 42 42 42 43 43 43 41 41 42 43 15 43 41 40 15 41 41 40 42 15 40 43 43 40 42 43
59 59 59 59 58 59 59 59 58 58 58 59 58 58 59 58 59 58 59 58 59 59 58 59 58 58 58 58 58 59 59 58 59 16 4 4 14 15 40 43 40 41 15 43 40 15 42 41 41 40 42 42 41 40 41 15 43 40 41 15 42 41 40 42 4 4 15 43 43 41 41 42 42 43 41 43 40 41 42 15 41 41 41 15 15 42 43 40 15 43 41 42 40 42 40 15 15 41 43 42
58 58 59 59 58 59 58 59 59 58 59 58 59 59 58 59 58 58 58 58 58 58 58 58 59 58 58 58 59 58 59 58 58 16 4 4 14 43 40 15 43 15 43 42 42 43 40 15 15 43 41 41 42 43 42 43 15 15 40 15 43 15 40 40 4 4 41 15 40 41 41 40 40 42 41 15 43 15 43 15 40 43 41 40 42 15 42 40 43 43 15 40 41 40 43 40 43 42 41 42
59 58 59 58 59 58 59 59 58 59 59 59 58 59 59 58 59 59 58 59 59 59 59 59 59 59 58 59 58 58 58 59 58 16 4 4 14 43 41 40 40 41 41 41 42 43 42 41 15 42 42 40 40 43 42 42 40 15 43 41 40 42 42 41 4 4 42 43 43 40 15 15 41 15 40 41 43 15 15 15 41 42 43 42 43 42 42 40 41 40 40 40 40 41 41 43 40 42 42 43
59 58 59 58 58 59 59 59 59 59 59 59 58 58 59 59 59 59 59 58 59 58 58 59 58 59 58 59 58 59 58 59 58 16 4 4 14 41 15 42 15 43 42 40 42 40 41 42 15 40 40 41 42 41 42 42 40 40 41 41 41 41 15 15 4 4 43 15 42 15 43 40 15 42 41 15 42 43 41 15 40 42 15 15 43 43 40 43 43 43 15 41 40 42 43 40 15 43 15 40
59 58 58 58 59 58 58 58 59 4 4 4 59 59 58 58 59 59 59 59 59 59 58 58 59 58 58 59 59 58 58 58 58 16 4 4 14 40 41 15 15 15 40 41 43 43 15 43 40 41 40 40 42 42 15 40 40 43 40 43 40 41 40 42 4 4 43 41 43 41 42 43 41 42 40 40 42 40 41 41 15 43 41 40 41 40 42 42 15 15 41 41 42 43 42 40 43 40 43 42
58 59 59 59 59 58 58 59 4 4 4 4 4 59 58 59 58 58 58 59 59 59 59 59 58 59 58 59 59 58 59 59 58 16 4 4 14 15 15 40 15 40 41 42 42 43 41 42 40 43 43 40 40 43 42 41 42 42 15 41 42 42 42 41 4 4 40 41 40 43 40 41 42 40 43 43 43 15 41 41 43 43 15 40 41 43 41 43 15 15 41 40 15 43 41 40 41 43 15 15
58 59 58 59 59 58 59 59 4 4 4 4 4 4 4 4 4 4 4 4 4 4 4 58 59 59 59 59 58 58 58 58 59 16 4 4 14 42 41 40 40 40 42 42 15 41 41 15 15 42 40 41 43 42 42 43 15 15 43 41 15 15 15 40 4 4 41 40 40 41 40 43 42 15 40 41 40 41 43 40 41 43 43 40 42 41 15 15 41 41 40 43 15 43 15 43 41 40 41 43
59 58 58 59 58 58 58 58 4 4 4 4 4 59 58 59 59 59 59 59 58 58 4 4 4 59 59 58 59 59 58 59 58 16 4 4 14 43 42 40 40 15 42 15 43 15 42 41 15 42 43 42 43 43 41 43 40 42 15 43 42 40 43 42 4 4 41 42 41 43 42 41 42 41 15 15 41 40 41 15 43 42 43 40 40 41 42 40 15 41 40 41 41 15 42 41 41 15 41 42
59 58 59 59 59 58 59 59 58 4 4 4 58 58 59 58 58 58 59 58 58 59 58 58 4 4 58 59 59 59 59 58 59 16 4 4 14 40 43 41 42 15 15 42 15 41 42 43 15 15 40 43 43 43 43 41 43 41 15 41 41 40 40 42 4 4 40 42 43 41 40 15 41 41 43 41 41 42 15 40 40 41 40 15 40 43 43 42 42 42 42 40 42 42 42 15 41 43 42 15
58 58 59 58 58 58 58 58 59 59 59 59 59 58 58 59 58 58 58 59 59 59 58 59 59 4 4 4 58 59 58 58 58 16 4 4 14 40 43 15 40 42 42 42 42 43 40 40 41 42 41 40 41 15 43 41 15 43 43 42 43 40 41 41 4 4 40 42 42 40 15 40 41 41 15 43 43 41 40 43 43 40 43 41 15 40 42 41 41 43 42 41 42 15 43 15 43 43 42 41
59 58 58 59 58 59 59 58 59 59 58 59 59 59 59 59 58 59 58 59 59 59 59 59 59 59 59 4 59 58 59 58 59 16 4 4 14 42 41 40 41 43 41 41 42 41 41 40 15 42 43 40 43 42 42 40 15 15 43 41 42 41 42 43 4 4 40 42 42 40 42 40 15 40 42 40 43 41 43 40 41 42 42 43 42 43 15 43 42 15 42 43 41 41 42 41 43 15 43 42
59 58 58 58 58 58 58 58 59 58 59 58 58 58 58 58 58 58 59 59 58 59 58 58 59 59 59 4 4 4 59 58 30 29 4 4 27 45 15 42 15 43 43 41 43 41 40 43 41 40 40 40 41 40 41 42 42 42 41 43 40 15 15 43 4 4 40 41 40 43 40 43 40 43 41 41 43 15 43 15 41 41 15 42 43 43 15 41 41 40 40 43 40 42 43 43 43 40 41 43
58 58 59 59 59 58 58 59 58 58 58 58 59 59 59 58 58 59 58 58 58 30 28 28 28 28 28 28 28 4 28 28 29 4 4 4 4 27 42 41 15 40 15 43 41 42 15 40 41 40 40 40 40 15 40 41 15 15 43 15 43 43 42 15 4 4 41 40 43 41 43 42 40 42 42 41 43 41 41 42 41 15 15 41 42 15 42 15 15 42 15 42 43 42 43 42 41 43 43 40
59 58 58 58 58 59 58 59 58 59 58 59 58 58 59 59 58 59 58 59 30 29 4 4 4 4 4 4 4 4 4 4 4 4 4 4 4 4 4 4 4 4 4 4 4 4 4 4 4 4 4 4 4 4 4 4 4 4 4 4 4 4 4 4 4 4 43 43 15 40 43 40 43 43 43 42 42 15 43 40 15 41 41 43 41 41 41 40 15 15 40 42 43 41 15 15 42 40 15 42
58 59 59 58 58 58 59 58 58 58 59 59 58 58 58 58 59 58 58 30 29 4 4 1 2 2 2 2 2 2 2 2 3 4 4 4 4 1 2 2 2 2 2 2 2 2 2 2 2 2 2 2 2 2 2 2 2 2 2 2 2 2 2 3 4 4 14 15 42 15 42 15 43 40 43 41 42 15 42 42 40 41 43 15 42 41 41 41 15 40 15 41 42 42 43 43 43 41 43 41
58 59 58 58 58 58 59 58 58 59 59 59 59 58 58 58 59 59 30 29 4 4 1 17 15 41 41 15 15 42 40 43 44 3 4 4 1 17 41 43 40 42 41 42 40 41 41 42 15 40 43 43 15 43 41 40 41 15 15 41 15 40 15 16 4 4 14 40 43 41 40 42 15 42 43 40 43 42 43 43 15 41 40 40 15 43 42 41 40 43 42 40 40 43 15 42 15 43 42 41
59 58 58 59 58 58 59 58 58 58 58 58 58 58 59 58 30 28 29 4 4 1 17 15 41 56 56 56 56 56 56 56 43 40 4 4 41 40 56 56 56 56 56 56 56 56 56 56 56 56 56 56 56 56 56 56 56 56 56 56 56 56 42 16 4 4 14 42 56 56 56 56 56 56 56 42 40 40 15 40 15 42 43 43 43 15 41 42 40 15 40 42 41 40 40 40 15 40 40 40
59 58 59 59 59 59 58 59 59 59 59 58 58 59 59 30 29 4 4 4 1 17 43 40 56 56 56 56 56 56 56 56 42 15 4 4 42 43 56 56 56 56 56 56 56 56 56 56 56 56 56 56 56 56 56 56 56 56 56 56 56 56 42 40 4 4 15 41 56 56 56 56 56 56 56 56 41 41 40 15 40 15 42 41 15 41 15 43 43 15 42 40 41 40 43 42 40 40 15 42
59 59 59 58 58 58 58 59 58 59 59 59 59 15 30 29 4 4 1 2 17 42 42 56 56 43 43 42 40 43 43 43 40 42 4 4 40 43 41 41 15 42 40 43 41 15 43 43 15 41 57 57 57 57 57 57 57 57 57 57 43 15 41 41 4 4 15 15 43 41 40 41 40 40 41 56 56 43 43 40 40 15 40 40 42 40 42 43 15 15 42 42 15 41 42 41 15 15 42 43
58 59 59 58 59 58 58 58 58 59 58 58 59 30 29 4 4 1 17 40 15 41 56 56 15 40 40 42 41 41 42 40 41 43 4 4 15 43 43 40 42 15 43 15 43 43 43 41 15 57 15 41 43 42 15 43 41 40 43 57 43 41 43 40 4 4 41 43 57 57 57 57 57 57 42 41 56 56 42 41 15 42 15 43 41 42 15 43 40 43 15 41 42 15 43 40 42 40 41 40
42 42 43 43 40 43 43 41 41 40 40 43 30 29 4 4 1 17 43 15 41 56 56 40 43 57 57 57 57 15 41 42 15 15 4 4 42 41 42 57 57 57 57 57 57 57 15 41 15 42 57 57 57 57 43 43 41 41 15 57 41 15 42 43 4 4 41 43 42 40 42 41 43 43 57 42 42 56 56 15 42 41 42 43 15 40 40 41 15 15 41 15 41 40 15 41 41 42 40 43
28 28 28 28 28 28 28 28 28 28 28 28 29 4 4 1 17 42 40 42 56 56 15 40 57 41 42 40 42 57 41 15 42 40 4 4 15 42 41 57 41 42 15 41 41 57 43 42 41 43 40 15 43 57 57 57 15 41 42 41 40 15 15 41 4 4 40 40 57 15 42 43 41 15 43 57 41 56 56 56 43 40 41 15 40 40 42 43 43 40 43 42 43 15 42 43 42 15 42 43
4 4 4 4 4 4 4 4 4 4 4 4 4 4 1 17 40 43 41 40 56 56 15 40 57 15 40 41 15 43 57 15 41 42 4 4 41 15 40 57 43 41 15 40 41 57 41 15 40 15 15 15 15 57 43 43 57 40 42 57 41 43 42 41 4 4 41 43 57 40 42 43 42 43 43 57 41 43 56 56 42 40 41 42 42 41 41 40 40 41 40 43 40 40 15 42 43 41 42 43
2 2 2 2 2 2 2 2 2 2 2 2 2 2 17 43 15 43 43 42 56 56 43 41 57 43 15 40 40 40 57 43 41 15 4 4 42 42 41 57 57 57 57 57 15 57 42 15 43 15 15 15 41 57 41 15 41 15 40 57 15 42 41 40 4 4 43 43 57 40 15 40 41 42 41 57 40 42 56 56 40 43 43 41 15 15 41 42 15 40 15 15 42 42 40 41 42 41 42 40
43 43 15 43 41 15 40 41 15 40 43 43 41 15 15 40 41 43 42 43 56 56 41 41 57 40 43 42 40 42 41 41 15 41 4 4 15 43 41 57 41 41 40 42 40 57 41 41 15 43 40 42 41 57 57 57 57 57 57 57 43 43 40 15 4 4 41 42 57 43 43 40 43 40 43 57 15 41 56 56 42 15 42 15 43 43 43 43 42 43 40 41 43 15 42 42 43 43 15 42
59 58 59 58 58 58 58 59 58 59 58 58 58 58 59 59 59 59 59 59 56 56 41 42 57 42 15 15 42 40 57 15 42 15 4 4 43 40 40 57 15 43 40 40 43 57 43 40 40 40 41 40 40 40 43 15 40 43 42 40 40 15 43 40 4 4 43 42 57 42 15 15 42 15 15 57 43 42 56 56 43 42 40 15 42 40 42 43 40 40 41 40 15 40 40 43 42 15 43 41
59 58 58 59 59 59 59 59 58 58 59 58 59 58 59 59 59 59 58 58 56 56 43 15 57 41 40 43 15 15 57 43 43 41 4 4 40 42 42 43 43 43 40 15 40 57 57 57 57 42 42 40 40 57 57 57 57 57 57 57 15 43 15 15 4 4 43 43 57 57 57 57 57 57 57 43 41 43 56 56 42 43 40 42 40 42 40 43 43 42 41 43 42 42 42 40 41 43 42 42
59 58 58 59 58 58 59 59 58 59 59 59 59 59 59 59 58 59 58 59 56 56 40 41 57 15 40 43 43 15 57 15 40 15 4 4 42 15 42 57 15 42 41 40 41 57 43 15 43 57 43 43 43 57 41 43 41 41 40 57 40 42 42 40 4 4 41 42 40 42 15 43 15 41 15 41 40 41 56 56 42 40 41 42 15 41 43 40 43 43 41 43 41 43 15 42 43 42 15 43
58 59 58 58 59 59 58 59 58 59 58 59 59 58 59 59 59 58 58 59 56 56 43 41 57 57 57 57 57 57 57 43 15 43 4 4 15 41 40 57 40 41 15 40 15 15 43 43 41 57 43 42 15 57 40 43 40 15 15 41 15 15 15 15 4 4 40 40 57 57 57 57 57 57 57 40 15 41 56 56 15 40 43 43 41 40 40 43 15 41 43 15 15 15 43 42 15 41 43 15
58 58 59 59 59 59 58 59 58 58 59 59 58 58 59 58 58 59 59 58 56 56 41 15 42 42 43 41 43 40 40 40 40 41 4 4 41 41 42 57 40 43 40 40 40 57 42 42 42 57 40 43 41 57 43 42 40 43 15 57 40 42 15 41 4 4 41 15 43 42 40 40 15 15 57 15 43 42 56 56 40 15 15 40 40 40 41 43 43 40 41 15 40 43 43 40 40 15 41 42
58 59 59 59 58 59 58 58 58 59 58 59 58 59 58 59 59 59 59 59 56 56 41 42 43 40 41 15 40 41 42 15 42 15 4 4 42 41 42 57 43 57 57 57 57 57 57 57 57 40 43 41 40 57 57 57 57 57 57 57 42 15 42 15 4 4 42 43 57 43 43 42 40 15 57 42 41 41 56 56 40 15 15 42 40 42 43 42 41 15 42 15 43 43 42 15 42 42 43 42
59 58 58 59 59 59 59 58 59 58 59 58 59 58 59 59 58 59 58 59 56 56 15 43 40 41 40 15 40 43 43 41 43 42 4 4 40 42 15 57 40 40 43 15 42 57 15 43 42 43 43 42 43 41 15 43 42 41 15 42 41 42 43 41 4 4 43 43 57 42 42 42 42 15 57 42 40 40 56 56 41 43 42 42 41 41 43 40 43 43 15 40 15 43 15 43 42 15 15 43
59 59 59 59 58 59 58 58 58 59 58 58 59 58 59 58 59 58 59 59 56 56 43 41 57 57 57 57 57 57 57 40 42 42 4 4 15 41 43 57 57 57 57 57 57 57 40 15 5 6 7 41 41 41 15 15 43 43 15 40 15 40 43 42 4 4 43 43 57 57 57 57 57 57 57 40 42 42 56 56 41 40 40 15 40 40 43 15 42 41 43 40 15 15 15 41 43 15 15 40
59 58 58 59 59 58 59 58 58 59 59 58 59 59 59 59 58 59 58 59 56 56 43 15 57 40 42 43 43 40 57 43 42 40 4 4 15 41 40 15 40 15 41 40 43 43 41 15 18 19 20 41 41 40 41 40 42 42 15 43 40 43 43 43 4 4 40 43 40 41 40 15 15 40 41 42 40 15 56 56 42 40 15 15 42 41 42 42 41 43 43 43 40 42 40 41 42 15 42 43
59 59 59 59 59 59 58 59 58 58 58 59 58 58 58 58 59 58 59 58 56 56 41 40 57 42 43 43 41 15 57 41 40 15 4 4 15 42 41 15 41 42 15 40 43 40 42 15 31 32 33 43 42 57 57 57 57 57 57 57 43 42 42 41 4 4 41 40 57 57 57 57 57 57 57 15 40 40 56 56 40 15 15 43 43 42 15 15 41 15 15 41 41 42 42 15 41 43 42 41
59 58 58 59 58 58 59 59 59 58 59 58 59 59 59 59 58 59 59 59 56 56 15 41 57 40 41 42 41 41 57 42 43 40 4 4 40 41 15 57 57 57 57 57 57 57 40 41 42 42 40 40 41 57 15 15 43 43 43 57 42 42 15 43 4 4 40 43 42 40 41 40 40 43 57 41 41 43 56 56 42 41 40 15 41 15 40 42 40 43 15 41 15 41 40 43 41 41 43 42
59 59 59 58 58 58 59 58 59 58 58 59 58 59 58 58 58 59 59 59 56 56 41 41 57 15 42 41 41 40 57 15 41 15 4 4 15 41 43 57 43 40 41 43 41 57 42 42 43 41 41 42 57 15 42 40 40 42 15 57 40 40 15 15 4 4 41 43 57 15 43 43 40 43 57 15 40 40 56 56 40 42 41 43 42 43 41 40 15 15 15 43 41 40 41 15 43 15 41 41
59 58 59 59 58 59 58 58 58 59 59 59 58 58 59 59 58 58 59 58 56 56 41 41 57 41 42 15 42 41 57 42 40 41 4 4 41 15 43 57 43 42 15 42 15 57 15 40 42 42 43 57 40 42 15 40 43 40 42 57 41 41 41 43 4 4 43 41 57 40 41 15 43 15 57 40 43 42 56 56 40 40 41 43 43 43 42 43 40 43 41 42 41 41 41 43 43 40 40 15
58 59 59 58 59 58 59 58 59 59 58 59 58 58 58 58 58 58 58 58 56 56 40 42 57 15 43 41 41 15 57 40 43 40 4 4 40 40 40 57 42 42 15 15 15 57 42 40 41 40 57 43 41 40 40 43 43 43 41 57 43 43 40 40 4 4 42 15 57 57 57 57 57 57 57 41 41 41 56 56 15 42 42 42 40 43 40 40 43 42 42 41 40 43 42 15 41 42 43 15
58 58 58 58 58 58 59 58 59 59 59 59 59 59 59 58 58 58 58 59 56 56 41 40 57 15 41 42 42 41 41 42 43 40 4 4 40 42 43 40 43 41 43 15 15 57 43 42 15 42 57 42 15 40 40 42 43 42 15 57 41 40 42 41 4 4 43 40 43 41 43 40 42 40 43 42 41 40 56 56 42 40 15 41 42 43 43 40 42 42 15 42 15 43 40 41 42 41 41 15
59 59 58 59 58 58 59 58 59 58 58 59 58 58 58 59 59 59 59 59 56 56 43 42 57 15 15 40 15 15 41 40 15 42 4 4 42 40 15 57 15 43 15 15 40 57 40 41 43 40 57 40 42 41 40 15 42 43 42 57 43 41 42 40 4 4 42 40 57 57 57 57 57 57 57 41 40 43 56 56 15 41 41 43 43 43 42 43 41 15 41 42 42 42 43 43 40 40 42 43
58 59 59 59 58 59 59 58 59 59 59 58 58 58 58 59 58 59 58 59 56 56 42 42 57 40 42 43 15 43 57 15 43 43 4 4 15 40 42 57 15 41 42 42 42 57 42 40 42 42 57 43 40 43 41 40 15 43 42 57 41 43 42 40 4 4 15 43 40 41 40 40 15 41 57 43 41 43 56 56 43 43 40 43 40 40 43 40 15 40 15 42 43 42 42 41 40 40 43 42
59 59 58 58 58 58 58 59 58 59 58 59 58 58 58 58 58 59 59 58 56 56 40 42 57 40 43 42 43 15 57 40 42 40 4 4 40 41 15 57 15 43 42 40 41 57 15 40 42 40 57 41 42 43 15 40 42 15 43 57 15 43 40 15 4 4 41 42 57 41 40 40 40 15 57 43 42 43 56 56 42 15 42 40 40 42 15 43 40 42 40 42 43 40 41 43 15 41 43 15
58 59 58 59 58 58 58 59 59 58 58 59 59 59 59 58 59 59 58 58 56 56 43 15 57 57 57 57 57 57 57 41 40 40 4 4 15 15 15 57 57 57 57 57 57 57 43 42 43 41 57 40 41 15 40 40 41 41 15 57 42 41 15 41 4 4 40 43 57 43 41 41 43 41 57 41 43 15 56 56 40 41 42 43 43 15 42 41 43 15 43 41 40 40 41 40 41 40 41 42
59 59 58 59 59 58 58 59 59 58 58 58 58 58 59 58 59 59 59 59 56 56 15 42 43 42 40 43 41 43 15 42 41 15 4 4 41 15 40 41 42 43 42 41 15 41 15 40 15 42 42 57 57 57 43 57 57 57 57 57 43 41 41 15 4 4 40 41 57 57 57 57 57 57 57 15 15 15 56 56 15 42 15 41 40 43 15 41 43 43 41 42 42 41 43 15 42 15 15 42
58 58 59 59 58 59 58 59 58 59 58 58 58 58 58 58 59 59 59 59 56 56 43 40 15 43 42 43 43 40 41 40 43 15 4 4 15 43 15 40 15 41 40 41 42 41 43 42 43 41 15 42 40 43 43 42 42 43 15 42 40 43 43 41 4 4 41 43 41 15 15 42 41 41 41 40 40 41 56 56 41 41 15 40 40 40 40 40 43 41 43 41 40 43 15 41 43 43 15 15
58 58 59 58 58 59 58 58 58 58 58 59 58 58 59 59 58 59 58 59 56 56 42 43 42 42 43 15 43 41 15 42 15 40 4 4 42 40 43 40 15 43 15 41 42 41 40 41 15 15 41 42 41 43 41 15 40 41 15 42 15 40 15 40 4 4 42 40 43 15 43 40 41 15 43 40 15 41 56 56 41 42 40 41 41 43 41 43 42 42 15 15 15 41 43 41 15 43 40 42
59 59 58 59 58 58 59 58 59 58 58 59 59 59 59 59 58 58 59 59 56 56 40 15 43 43 41 40 43 40 40 15 41 41 4 4 15 15 15 15 15 43 43 40 42 15 41 41 42 40 40 40 40 40 15 41 42 42 15 41 15 42 40 43 4 4 15 15 43 15 41 43 15 43 40 15 41 43 56 56 43 42 43 15 43 40 40 43 43 43 43 43 40 40 42 41 40 41 42 43
59 59 59 58 58 58 58 59 59 59 58 59 59 58 58 59 59 59 59 58 56 56 41 43 43 40 15 42 43 40 41 42 43 41 4 4 41 43 40 15 15 15 42 43 43 40 43 43 43 40 40 40 42 42 40 43 40 15 42 42 15 42 42 42 4 4 42 43 15 42 40 41 15 15 42 43 15 15 56 56 40 43 42 42 42 15 41 41 40 15 40 41 43 40 40 40 40 40 41 40
59 59 59 58 59 58 59 59 58 59 59 59 59 59 58 58 59 58 59 58 56 56 42 43 42 15 42 41 40 15 41 42 43 42 4 4 43 15 41 15 15 43 43 40 40 41 15 40 40 42 41 42 40 41 15 42 40 40 40 15 41 42 42 43 4 4 41 43 43 40 40 15 43 40 40 41 40 42 56 56 43 43 43 15 42 41 40 15 40 15 15 40 40 40 43 41 15 40 43 40
58 59 58 58 59 59 59 58 59 59 59 59 59 59 58 58 58 58 58 58 56 56 42 41 41 43 43 15 40 15 41 40 15 15 4 4 42 40 15 42 42 15 41 15 43 40 43 40 40 42 41 43 42 43 42 40 41 41 41 41 43 40 15 15 4 4 43 40 41 42 42 41 15 42 42 42 15 40 56 56 15 15 41 42 43 41 15 41 43 42 43 43 41 40 41 43 43 42 15 41
58 59 59 58 59 58 58 59 59 58 58 59 59 59 59 59 59 59 58 59 56 56 42 41 42 40 40 15 41 42 43 41 42 41 4 4 42 43 43 40 42 41 43 42 41 15 40 42 41 41 41 41 15 15 43 43 43 43 40 40 15 42 15 40 4 4 42 40 43 42 43 15 40 42 41 43 43 42 56 56 42 15 43 43 41 41 43 42 42 43 15 43 42 40 41 42 40 43 42 15
58 58 59 58 58 58 59 58 59 58 59 58 58 58 59 59 59 58 58 58 56 56 40 41 41 43 43 42 41 42 40 40 41 42 4 4 40 43 15 42 42 15 41 15 15 15 15 41 40 41 15 42 15 41 15 15 41 43 41 42 42 43 15 41 4 4 40 43 43 15 41 15 42 42 42 43 41 40 56 56 42 15 42 15 42 42 43 41 41 15 41 40 15 42 43 41 40 40 40 42
58 59 59 59 59 58 58 58 58 59 59 58 59 59 59 58 58 59 58 59 56 56 40 43 41 41 43 43 41 42 42 41 15 42 4 4 41 42 4 4 4 4 4 4 4 4 4 4 4 4 4 4 4 4 4 4 4 4 4 4 4 41 43 42 4 4 15 42 40 42 43 42 41 41 41 41 15 40 56 56 43 15 15 42 15 42 15 40 43 43 42 42 43 15 42 42 40 40 43 15
59 58 58 58 59 58 58 59 59 59 59 58 58 58 59 59 58 59 59 59 56 56 43 41 15 42 15 42 43 15 43 42 41 43 4 4 4 4 4 43 15 43 43 43 42 15 4 4 42 15 40 42 43 4 4 43 41 42 42 42 41 4 4 4 4 4 40 41 40 40 42 43 43 41 40 43 15 40 56 56 40 40 42 41 41 41 40 40 41 41 15 40 15 42 41 40 42 42 43 42
58 59 58 58 59 58 58 58 59 58 58 58 58 59 58 58 58 58 58 59 56 56 42 41 43 15 15 15 41 42 43 43 43 42 4 4 40 40 40 15 41 42 42 40 42 41 4 4 43 43 42 15 41 4 4 15 42 40 43 42 40 42 42 15 4 4 42 15 43 15 43 41 41 41 43 41 42 42 56 56 40 42 15 43 42 42 41 43 42 15 41 15 41 43 43 40 40 41 40 42
59 58 58 58 58 58 59 59 58 58 58 59 59 59 58 59 59 59 59 58 56 56 40 15 43 15 15 40 15 15 42 42 42 40 4 4 40 41 41 40 41 42 40 41 43 41 4 4 15 42 43 43 41 4 4 42 42 43 42 15 41 41 42 43 4 4 42 42 42 40 40 41 43 15 42 40 15 41 56 56 40 40 41 41 43 41 41 15 15 41 15 43 41 15 41 42 41 40 15 15
59 58 59 59 59 58 59 59 58 59 58 59 59 59 58 58 59 59 59 59 56 56 40 15 41 42 41 15 43 40 15 43 15 40 4 4 42 42 40 42 42 42 43 57 57 57 4 4 57 57 57 57 57 4 4 57 57 42 40 42 15 40 42 43 4 4 42 41 40 41 41 43 42 41 15 43 40 15 56 56 15 43 40 40 40 15 43 15 41 40 43 15 15 43 41 42 15 42 43 42
59 58 58 58 59 59 58 59 58 59 58 58 58 58 58 59 58 59 58 59 56 56 15 15 40 43 42 40 15 42 40 42 42 42 4 4 15 42 42 41 15 40 57 43 42 15 4 4 4 4 4 4 4 4 4 43 15 57 40 41 15 15 42 43 4 4 42 41 15 42 42 41 15 15 41 15 43 43 56 56 43 41 41 43 40 41 40 40 41 41 15 15 42 41 43 15 43 42 15 15
59 58 58 58 59 58 59 58 59 59 59 59 58 58 58 58 59 59 59 58 56 56 40 15 43 42 15 42 41 41 43 40 15 43 4 4 42 40 15 41 41 57 41 42 4 4 4 5 6 6 6 6 7 4 4 4 43 42 57 43 15 40 15 41 4 4 41 15 42 41 41 43 43 40 41 43 15 40 56 56 41 40 41 42 42 15 40 40 42 40 42 15 41 15 40 42 15 43 15 42
59 59 58 59 58 58 59 58 58 59 58 59 59 59 58 58 58 59 59 58 56 56 41 40 15 43 43 43 15 40 40 41 42 43 4 4 43 43 15 40 57 43 42 4 4 4 4 18 19 19 19 19 20 4 4 4 4 41 41 57 40 15 43 41 4 4 42 15 43 43 40 15 40 41 40 41 42 41 56 56 40 43 43 42 40 43 42 43 40 41 42 41 41 15 43 43 40 41 40 43
59 59 59 58 58 58 58 58 59 59 59 58 59 59 58 59 58 59 59 58 56 56 41 43 43 15 40 15 42 40 43 15 15 15 4 4 15 42 42 57 15 40 4 4 4 4 4 31 32 32 32 32 33 4 4 4 4 4 41 40 57 40 42 43 4 4 15 40 43 41 42 43 15 41 43 42 40 42 56 56 41 15 42 15 40 15 40 42 42 15 43 41 43 41 41 43 43 42 42 15
58 58 58 59 59 59 58 59 59 58 58 58 59 58 58 59 58 58 59 59 56 56 42 43 42 43 15 41 15 40 41 42 41 40 4 4 15 42 42 57 41 4 4 4 4 4 4 4 4 4 4 4 4 4 4 4 4 4 4 42 57 42 42 41 4 4 41 43 41 41 43 41 42 40 40 43 42 40 56 56 43 15 43 42 42 15 42 15 40 41 41 43 15 43 42 40 41 41 15 41
59 59 58 59 58 59 59 59 59 58 58 59 58 58 58 58 59 58 58 59 56 56 43 43 15 40 42 43 43 40 15 43 42 41 4 4 15 41 42 57 4 4 4 4 4 4 4 4 4 4 4 4 4 4 4 4 4 4 4 4 57 41 42 15 4 4 43 41 42 15 40 41 43 42 42 43 41 42 56 56 15 41 40 41 41 40 41 41 42 42 15 40 40 40 42 43 42 40 41 41
58 58 59 58 59 59 58 59 58 59 59 59 59 58 58 58 58 58 58 59 56 56 41 43 41 40 15 15 43 42 41 41 15 42 4 4 41 41 40 57 4 4 4 57 57 57 57 57 57 15 42 57 57 57 57 57 57 4 4 4 57 15 41 40 4 4 40 41 41 41 40 15 43 43 15 40 15 43 56 56 43 42 15 43 40 43 42 40 42 42 40 41 42 42 15 42 43 42 41 40
58 58 58 59 59 59 59 59 59 58 58 58 59 58 58 58 59 58 58 58 56 56 41 42 40 15 40 43 42 15 43 43 42 41 4 4 41 41 43 57 4 4 57 40 42 43 15 42 43 42 43 15 15 15 41 41 41 57 4 4 57 43 43 43 4 4 41 40 15 43 40 42 40 40 15 15 15 42 56 56 15 40 41 40 40 40 40 40 42 41 42 15 43 43 42 42 42 43 41 43
59 58 59 58 59 59 58 59 59 58 59 58 59 58 59 58 59 58 59 58 56 56 40 42 15 15 43 42 42 43 15 42 41 43 4 4 41 40 42 57 4 57 15 43 41 43 43 42 42 43 41 42 15 42 43 43 42 42 57 4 57 40 15 40 4 4 15 41 15 42 15 15 42 15 15 40 41 41 56 56 42 40 42 40 43 42 42 40 40 42 43 40 15 40 42 41 43 15 15 41
58 59 58 59 58 58 59 59 59 59 59 58 58 59 58 58 58 59 59 59 56 56 15 42 42 41 15 41 42 43 43 42 43 43 4 4 41 42 41 57 4 57 15 40 42 40 15 43 41 43 40 15 15 40 43 42 40 42 57 4 57 43 40 42 4 4 42 42 43 41 41 15 41 42 15 40 42 40 56 56 40 15 41 15 41 40 15 40 43 40 40 15 40 40 42 41 15 41 43 42
58 59 58 59 59 59 59 59 58 59 58 59 58 59 58 58 59 58 58 59 56 56 40 40 40 41 42 40 43 15 43 43 40 42 4 4 43 42 43 57 4 57 43 15 43 41 15 43 57 40 15 57 41 40 15 43 41 40 57 4 57 43 42 15 4 4 41 42 15 42 40 42 42 15 15 43 43 15 56 56 42 40 42 43 42 15 15 40 15 41 42 41 42 43 42 42 15 15 43 15
59 58 58 59 58 58 58 59 58 59 59 58 58 59 58 59 59 58 59 58 56 56 42 15 43 40 40 15 42 41 15 40 40 15 4 4 15 42 40 57 4 57 41 40 43 40 15 57 15 41 41 15 57 15 15 41 41 41 57 4 57 40 40 41 4 4 15 41 40 42 40 40 43 42 15 43 15 15 56 56 43 40 40 42 15 40 40 43 15 40 42 41 15 40 40 41 15 42 42 41
58 59 58 58 59 59 59 58 58 59 58 58 58 58 58 59 59 59 59 59 56 56 41 40 15 41 42 42 40 41 42 40 43 40 4 4 42 40 40 57 4 57 42 41 43 40 15 57 15 41 15 43 57 15 42 41 43 15 57 4 57 43 42 40 4 4 40 15 40 42 41 15 43 42 40 15 43 42 56 56 41 40 15 40 41 41 40 43 43 42 42 40 42 43 41 15 43 15 15 41
58 59 58 59 59 58 59 59 58 58 58 58 59 58 59 58 58 59 58 59 58 56 56 41 43 40 42 40 42 42 15 42 15 15 4 4 41 42 43 57 4 57 41 41 43 42 41 57 43 42 40 41 57 15 15 41 41 40 57 4 57 40 43 40 4 4 15 42 43 42 43 40 42 42 43 15 42 56 56 15 41 41 15 40 41 43 15 40 41 40 15 43 15 41 15 43 40 40 40 43
59 58 58 59 58 59 59 59 58 58 58 59 58 58 58 58 59 58 58 58 58 59 56 56 15 42 41 41 41 42 41 41 41 40 4 4 15 40 40 57 4 57 42 42 15 42 40 57 15 40 43 40 57 15 15 41 42 43 57 4 57 15 40 41 4 4 42 15 42 40 43 40 42 15 41 42 56 56 41 43 40 42 42 15 43 40 40 40 40 41 41 15 40 15 43 15 40 43 15 40
58 58 58 5 59 58 59 59 59 59 59 59 58 58 59 58 58 58 59 58 59 59 59 56 56 41 42 43 41 41 42 15 15 42 4 4 15 43 41 57 4 57 15 42 42 42 40 57 42 40 42 15 57 15 15 15 41 15 57 4 57 41 43 40 4 4 41 15 42 40 42 42 42 41 41 56 56 42 42 41 43 43 42 40 43 40 43 15 40 42 41 42 42 43 42 40 41 41 43 40
59 58 59 59 59 58 59 58 58 58 59 59 58 58 58 59 58 59 58 58 59 59 59 58 56 56 56 56 56 56 56 56 4 4 4 4 4 4 56 56 56 56 56 56 56 56 56 56 56 56 56 56 56 56 56 56 56 56 56 56 56 56 15 40 4 4 41 43 56 56 56 56 56 56 56 56 40 41 41 42 42 42 15 40 43 40 42 40 15 42 40 43 15 15 43 40 43 15 40 15
15 15 43 41 41 41 42 43 43 15 40 40 15 43 40 41 42 42 40 58 59 58 59 59 43 56 56 56 56 56 56 56 4 4 4 4 4 4 56 56 56 56 56 56 56 56 56 56 56 56 56 56 56 56 56 56 56 56 56 56 56 56 41 40 43 15 41 43 56 56 56 56 56 56 56 41 42 41 40 42 42 15 40 42 40 15 43 43 41 43 40 42 42 42 40 41 15 41 40 43
15 42 42 42 15 15 42 41 40 42 15 15 15 15 40 40 15 40 42 40 15 41 40 40 43 42 43 41 43 43 40 16 4 4 4 4 4 4 14 43 42 41 15 42 40 40 40 42 15 40 40 15 41 42 42 15 41 41 43 15 42 41 40 42 42 43 41 42 40 43 41 42 40 15 42 43 40 15 15 15 40 15 42 40 58 59 58 58 59 59 58 58 58 58 59 58 58 59 59 58
28 28 28 28 28 28 28 28 28 28 28 28 28 28 28 28 28 28 28 28 28 28 28 28 28 28 28 28 28 28 28 29 4 4 4 4 4 4 14 41 41 43 42 43 15 42 15 43 43 40 15 43 43 41 41 42 41 41 40 41 43 15 41 40 43 43 15 43 40 40 15 15 43 43 41 40 43 41 43 15 43 40 15 40 59 59 58 59 58 59 58 59 59 59 58 58 58 58 59 59
4 4 4 4 4 4 4 4 4 4 4 4 4 4 4 4 4 4 4 4 4 4 4 4 4 4 4 4 4 4 4 4 4 4 4 4 4 4 14 42 42 43 43 15 42 15 15 43 43 42 41 40 43 40 40 42 40 40 41 42 42 40 42 15 43 41 40 15 42 15 43 42 42 42 41 42 15 15 43 40 42 15 15 15 58 59 59 59 58 59 58 58 58 59 59 58 59 59 59 59
2 2 2 2 2 2 2 2 2 2 2 2 5 6 6 6 6 6 7 2 2 2 3 4 4 1 2 2 2 2 2 2 2 3 4 4 1 2 17 15 15 40 41 42 41 41 15 42 42 42 15 42 41 15 42 15 41 42 40 15 43 42 43 40 42 43 15 15 43 15 41 43 15 41 43 40 41 41 41 43 42 43 41 41 59 58 58 59 59 58 58 59 58 58 58 59 58 59 58 58
6 6 6 6 6 6 6 6 6 6 6 6 21 19 19 19 19 19 20 41 41 42 16 4 4 14 40 58 58 58 58 59 59 41 4 4 43 43 15 15 43 41 43 43 42 41 42 43 40 41 43 40 41 42 15 40 40 43 15 40 42 15 15 15 41 40 41 41 43 43 40 43 41 42 41 40 43 40 41 42 41 43 41 40 59 58 59 58 59 58 58 59 59 58 59 59 59 59 59 59
19 19 19 19 19 19 19 19 19 19 19 19 19 19 19 19 19 19 20 41 42 43 16 4 4 14 40 58 58 58 58 58 59 43 4 4 41 42 41 42 42 43 15 43 40 40 15 40 42 40 15 15 43 15 15 15 43 43 41 43 42 41 41 41 15 15 43 43 41 40 41 41 43 41 40 42 15 42 40 42 15 43 43 40 59 59 58 59 58 59 58 59 58 58 59 59 58 59 59 58
19 19 19 19 19 19 19 19 19 19 19 19 19 19 19 19 19 19 20 42 40 15 16 4 4 14 41 59 59 59 58 58 58 42 4 4 40 15 41 43 42 40 40 15 41 42 43 41 15 43 40 42 41 15 43 41 41 40 15 43 41 43 40 40 42 15 41 42 15 15 41 40 43 43 41 43 43 43 41 40 43 40 15 42 59 59 58 59 59 58 58 58 59 59 58 58 58 59 59 58
19 19 19 19 19 19 19 19 19 19 19 19 19 19 34 32 32 32 33 40 43 42 16 4 4 14 15 58 59 58 59 58 58 40 4 4 41 15 40 40 42 15 43 40 15 41 41 41 43 41 15 41 41 41 42 43 43 40 43 15 40 43 42 42 43 15 41 42 15 43 41 15 42 41 41 40 41 40 41 43 41 41 15 41 58 59 59 59 59 58 59 58 59 59 59 58 59 58 59 58
19 19 19 19 19 19 19 19 19 19 19 19 19 19 20 15 15 15 30 28 28 28 29 4 4 14 41 59 58 59 59 58 58 43 4 4 43 41 15 42 43 15 40 40 43 43 15 41 40 43 40 40 40 42 41 40 43 43 41 40 15 40 15 40 42 40 42 41 43 41 15 43 15 15 41 15 40 41 40 40 41 43 42 41 59 58 58 58 58 59 59 58 58 58 58 58 58 59 58 59
19 19 19 19 19 19 19 19 19 19 19 19 19 19 20 42 59 59 16 4 4 4 4 4 4 14 15 58 58 59 59 58 59 43 4 4 41 43 43 41 42 43 43 42 43 43 15 41 42 40 15 15 41 15 41 40 43 43 43 40 42 41 15 15 42 41 43 42 41 43 43 41 42 41 15 43 40 41 15 41 43 40 43 41 58 59 59 58 58 58 58 58 59 59 59 58 59 58 59 58
19 19 19 19 19 19 19 19 19 19 19 19 19 19 20 42 59 59 16 4 4 4 4 4 4 14 15 59 58 58 59 59 59 41 4 4 40 41 40 41 43 15 40 41 15 40 15 43 15 41 43 15 40 43 41 43 40 40 43 15 40 42 40 40 42 41 40 15 42 41 15 43 42 41 40 40 42 42 40 15 40 42 15 43 58 58 58 59 58 58 58 58 58 59 59 58 59 59 58 58
19 19 19 19 19 19 19 19 19 19 19 19 19 19 20 15 58 59 16 4 14 15 42 43 15 42 15 59 58 58 59 59 58 15 4 4 41 41 43 41 40 41 15 40 42 42 42 15 43 43 41 15 43 43 41 15 40 41 43 15 40 15 40 42 40 43 15 43 15 41 40 15 43 40 43 15 41 43 43 40 41 43 42 41 58 58 59 59 59 59 58 59 59 59 59 58 59 59 59 58
19 19 19 19 19 19 19 19 19 19 19 19 19 19 20 42 59 58 16 4 14 42 59 58 59 59 59 58 58 58 58 58 59 42 4 4 41 43 43 15 42 42 41 43 15 42 15 40 41 41 15 42 42 43 41 43 40 40 15 43 40 43 40 42 43 42 15 41 15 15 42 15 40 43 15 40 42 41 40 42 15 15 42 15 58 58 58 58 58 59 58 58 58 58 58 59 58 58 58 58
19 19 19 19 19 19 19 19 19 19 19 19 19 19 20 43 58 59 16 4 14 15 59 58 59 59 58 59 58 59 58 58 58 42 4 4 40 40 15 40 41 41 41 43 41 40 15 40 42 41 42 41 15 15 42 40 40 40 15 40 15 43 42 42 40 41 40 40 42 40 40 42 15 15 42 41 42 40 41 40 43 41 41 15 58 59 58 58 58 58 58 58 58 58 58 59 59 59 59 58
19 19 19 19 19 19 19 19 19 19 19 19 19 19 20 42 59 59 16 4 14 43 59 58 58 59 58 59 58 59 59 58 15 40 4 4 43 43 43 15 41 41 41 43 42 42 43 41 43 40 43 15 42 15 41 15 15 43 15 42 40 15 43 41 41 41 41 42 15 41 42 43 43 43 40 41 15 15 43 41 42 43 15 41 59 58 58 58 59 59 59 58 58 59 59 58 59 58 59 59
19 19 19 19 19 19 19 19 19 19 19 19 19 19 20 42 59 59 16 4 14 15 58 59 59 59 58 59 59 58 59 59 41 42 4 4 43 15 42 15 15 41 40 40 42 43 43 40 43 40 15 15 41 42 40 43 40 43 15 43 43 40 42 43 40 40 40 15 15 42 40 41 41 42 15 42 43 43 40 40 42 40 43 40 59 58 58 58 59 59 59 59 58 59 59 59 59 58 59 59
19 19 19 19 19 19 19 19 19 19 19 19 19 19 20 41 59 59 16 4 14 15 58 58 58 58 58 58 59 58 58 15 43 41 4 4 15 43 42 43 40 41 40 15 41 42 15 41 41 15 41 42 40 40 42 41 40 42 43 43 15 41 15 15 40 15 42 15 40 42 15 15 42 43 41 41 40 41 43 41 41 15 43 40 59 58 58 59 58 59 58 58 59 58 59 59 58 58 59 59
19 19 19 19 19 34 32 32 32 32 32 32 32 32 33 15 41 15 16 4 14 15 58 59 59 58 58 58 59 58 58 40 15 43 4 4 43 15 41 42 15 40 40 41 42 15 40 42 42 42 43 41 42 43 43 42 15 40 42 42 43 15 42 43 41 42 42 43 40 42 41 43 42 40 41 15 40 41 43 15 41 41 41 43 59 59 58 58 59 59 58 58 58 59 58 59 58 58 58 59
19 19 19 19 19 20 30 28 28 28 28 28 28 28 28 28 28 28 29 4 14 42 59 58 59 58 59 59 59 58 59 15 4 4 4 4 4 4 41 15 15 41 15 41 42 42 40 42 42 43 40 43 15 40 43 40 43 42 42 43 40 43 43 43 41 41 15 15 41 41 43 41 42 15 41 43 42 41 41 43 15 40 43 15 58 59 59 59 59 58 58 59 59 58 58 59 59 59 59 58
19 19 19 19 19 20 16 4 4 4 4 4 4 4 4 4 4 4 4 4 14 43 59 59 59 59 58 59 59 58 59 40 4 4 4 4 4 4 43 42 40 42 40 43 40 41 42 43 15 42 15 42 41 41 42 41 43 15 43 41 43 42 42 41 42 43 42 43 43 15 42 42 15 43 15 42 15 42 41 43 42 41 41 43 58 58 58 59 59 58 59 58 59 58 59 59 58 58 59 59