55,55,55,55,55,55,45,45,45,55,56,56,55,45,45,45,55,55,55,55,55,55,55,55,55,45,45,45,45,45
55,56,56,56,56,55,45,45,45,55,56,56,55,45,45,45,55,56,56,56,56,56,56,56,55,45,45,55,55,55
55,56,56,56,56,55,45,45,45,55,56,56,55,45,45,45,55,56,56,56,56,56,56,56,55,45,45,55,56,56
55,56,56,56,56,55,45,45,45,55,56,56,55,45,45,45,55,55,55,55,56,56,56,56,55,45,45,55,56,56
55,56,56,56,56,55,55,55,55,55,56,56,55,45,45,45,45,45,45,55,56,56,56,56,55,55,55,55,56,56
55,56,56,56,56,56,56,56,56,56,56,56,55,55,55,55,55,55,55,55,56,56,56,56,56,56,55,55,56,56
55,56,56,56,56,56,56,56,56,56,56,56,56,56,56,56,56,56,56,56,56,56,56,56,56,56,55,55,56,56
55,55,55,55,55,55,55,55,55,55,56,56,56,56,56,56,56,56,56,56,56,56,56,56,56,56,55,55,56,56
45,45,45,45,45,45,45,45,45,55,56,56,55,55,55,55,55,55,55,55,55,55,55,55,55,55,55,55,56,56
55,55,55,55,55,55,55,55,55,55,56,56,55,45,45,45,45,45,45,45,45,45,45,45,45,45,55,56,56,56
55,56,56,56,56,56,56,56,56,56,56,56,55,55,55,55,55,55,55,55,55,55,55,55,55,55,55,56,56,56
55,56,56,56,56,56,56,56,56,56,56,56,56,56,56,56,56,56,56,56,56,56,56,56,56,56,56,56,56,56
55,56,55,55,55,55,55,55,55,55,56,56,55,55,55,55,55,55,55,55,55,55,55,55,55,55,56,56,56,56
55,56,55,45,45,45,45,45,45,55,56,56,55,45,45,45,45,45,45,45,45,45,45,45,55,55,56,56,56,56
55,55,55,45,45,45,45,45,45,55,56,56,55,55,55,55,55,55,55,55,55,55,45,45,45,55,55,55,56,56
45,45,45,45,45,45,45,55,55,56,56,56,56,56,56,56,56,56,56,56,56,55,55,45,45,45,45,55,55,55
45,45,45,45,45,45,55,55,56,56,56,56,56,56,56,56,56,56,56,56,56,56,55,55,55,45,45,45,45,45
45,45,45,55,55,55,55,56,56,56,56,56,56,56,56,56,56,56,56,56,56,56,56,56,55,55,55,45,45,45
55,55,55,55,56,56,56,56,56,56,56,56,56,56,56,56,56,56,56,56,56,56,56,56,56,56,55,45,45,45
55,55,55,55,55,55,55,55,55,55,55,55,55,55,55,55,55,55,55,55,55,55,55,55,56,55,55,45,45,45
45,45,45,45,45,45,45,45,45,45,45,45,45,45,45,45,45,45,45,45,45,45,55,55,56,55,45,45,45,45
45,45,45,45,45,45,45,45,45,45,45,45,45,45,45,45,45,45,45,45,45,45,55,56,56,55,45,45,45,45
55,55,55,55,55,55,55,55,55,55,45,45,45,45,45,45,45,45,45,45,45,45,55,56,55,55,45,45,45,45
56,56,56,56,56,56,56,56,56,55,55,45,45,45,45,45,45,45,45,45,45,45,55,56,55,45,45,45,45,45
56,56,56,56,56,56,56,56,56,56,55,55,55,55,55,55,55,55,55,45,45,45,55,56,55,45,45,45,45,45
56,56,56,56,56,56,56,56,56,56,56,56,56,56,56,56,56,56,55,45,45,45,55,56,55,45,45,45,45,45
56,56,56,56,56,56,56,56,56,56,56,56,56,56,56,56,56,56,55,45,45,45,55,56,55,45,45,45,45,45
56,56,56,56,56,56,56,56,56,56,55,55,55,55,55,55,55,56,55,55,55,55,55,56,55,45,45,45,45,45
56,56,56,56,56,56,56,56,56,55,55,45,45,45,45,45,55,56,56,56,56,56,56,56,55,45,45,45,45,45
55,55,55,55,55,55,55,55,55,55,45,45,45,45,45,45,55,55,55,55,55,55,55,55,55,45,45,45,45,45
