2215,2215,2215,2215,2215,2215,2215,2215,2215,2215,2215,2215,2215,2215,2215,2215,2215,2215,2215,2215,2215,2215,2215,2215,2215,2215,2215,2215,2215,2215,2215,2215,2215,2215,2215,2215,2215,2215,2215,2215,2215,2215,2215,2215,2215,2215,2215,2215,2215,2215,2215,2215,2215,2215,2215,2215,2215,2215,2215,2215,2215,2215,2215,2215,2215,2215,2215,2215,2215,2215
2215,2215,2215,2215,2215,2215,2215,2215,2215,2215,2215,2215,2215,2215,2215,2215,2215,2215,2215,2215,2215,2215,2215,2215,2215,2215,2215,2215,2215,2215,2215,2215,2215,2215,2215,2215,2215,2215,2215,2215,2215,2215,2215,2215,2215,2215,2215,2215,2215,2215,2215,2215,2215,2215,2215,2215,2215,2215,2215,2215,2215,2215,2215,2215,2215,2215,2215,2215,2215,2215
2215,2215,2215,2215,2215,2215,2215,2215,2215,2215,2215,2215,2215,2215,2215,2215,2215,2215,2215,2215,2215,2215,2215,2215,2215,2215,2215,2215,2215,2215,2215,2215,2215,2215,2215,2215,2215,2215,2215,2215,2215,2215,2215,2215,2215,2215,2215,2215,2215,2215,2215,2215,2215,2215,2215,2215,2215,2215,2215,2215,2215,2215,2215,2215,2215,2215,2215,2215,2215,2215
2215,2215,2215,2215,2215,2215,2215,2215,2215,2215,2215,2215,2215,2215,2215,2215,2215,2215,2215,2215,2215,2215,2215,2215,2215,2215,2215,2215,2215,2215,2215,2215,2215,2215,2215,2215,2215,2215,2215,2215,2215,2215,2215,2215,2215,2215,2215,2215,2215,2215,2215,2215,2215,2215,2215,2215,2215,2215,2215,2215,2215,2215,2215,2215,2215,2215,2215,2215,2215,2215
2215,2215,2215,2215,2215,2215,2215,2215,2215,2215,2215,2215,2215,2215,2215,2215,2215,2215,2215,2215,2215,2215,2215,2215,2215,2215,2215,2215,2215,2215,2215,2215,2215,2215,2265,2265,2265,2265,2215,2215,2215,2215,2215,2215,2215,2215,2215,2215,2215,2215,2215,2215,2215,2215,2215,2215,2215,2215,2215,2215,2215,2215,2215,2215,2215,2215,2215,2215,2215,2215
2215,2215,2215,2215,2215,2215,2215,2215,2215,2215,2215,2215,2215,2215,2215,2215,2215,2215,2464,2464,2464,2464,2464,2464,2464,2464,2215,2215,2215,2215,2215,2215,2215,2215,2265,2265,2265,2265,2215,2215,2215,2215,2215,2215,2215,2265,2265,2265,2265,2265,2265,2265,2265,2265,2265,2265,2265,2215,2215,2215,2215,2215,2215,2215,2215,2215,2215,2215,2215,2215
2215,2215,2215,2215,2215,2215,2215,2215,2215,2215,2215,2215,2215,2215,2215,2215,2215,2464,2265,2265,2265,2265,2265,2265,2265,2265,2464,2215,2215,2215,2215,2215,2215,2215,2265,2265,2265,2265,2215,2215,2215,2215,2215,2215,2265,2265,2265,2265,2265,2265,2265,2265,2265,2265,2265,2265,2265,2265,2215,2215,2215,2215,2215,2215,2215,2215,2215,2215,2215,2215
2215,2215,2215,2215,2215,2215,2215,2215,2215,2215,2215,2215,2215,2215,2215,2215,2464,2265,2265,2265,2265,2265,2265,2265,2265,2265,2265,2464,2215,2215,2215,2215,2215,2215,2265,2265,2265,2265,2215,2215,2215,2215,2215,2265,2265,2265,2265,2265,2265,2265,2265,2265,2265,2265,2265,2265,2265,2265,2265,2215,2215,2215,2215,2215,2215,2215,2215,2215,2215,2215
2215,2215,2215,2215,2215,2215,2215,2215,2215,2215,2215,2215,2215,2215,2215,2464,2265,2265,2265,2265,2265,2265,2265,2265,2265,2265,2265,2265,2464,2215,2215,2215,2215,2215,2265,2265,2265,2265,2215,2215,2215,2215,2265,2265,2265,2265,2265,2265,2265,2265,2265,2265,2265,2265,2265,2265,2265,2265,2265,2265,2215,2215,2215,2215,2215,2215,2215,2215,2215,2215
2215,2215,2215,2215,2215,2215,2215,2215,2215,2215,2215,2215,2215,2215,2464,2265,2265,2265,2265,2265,2265,2265,2265,2265,2265,2265,2265,2265,2265,2464,2215,2215,2215,2215,2265,2265,2265,2265,2215,2215,2215,2215,2265,2265,2265,2265,2265,2265,2265,2265,2265,2265,2265,2265,2265,2265,2265,2265,2265,2265,2265,2215,2215,2215,2215,2215,2215,2215,2215,2215
2215,2215,2215,2215,2215,2215,2215,2215,2215,2215,2215,2215,2215,2215,2265,2265,2265,2265,2265,2265,2265,2265,2265,2265,2265,2265,2265,2265,2265,2265,2215,2215,2215,2215,2265,2265,2265,2265,2215,2215,2215,2215,2265,2265,2265,2265,2265,2265,2265,2265,2265,2265,2265,2265,2265,2265,2265,2265,2265,2265,2265,2215,2215,2215,2215,2215,2215,2215,2215,2215
2215,2215,2215,2215,2215,2215,2215,2215,2215,2215,2215,2215,2215,2215,2265,2265,2265,2265,2265,2265,2265,2265,2265,2265,2265,2265,2265,2265,2265,2265,2215,2215,2215,2215,2265,2265,2265,2265,2215,2215,2215,2215,2265,2265,2265,2265,2265,2265,2265,2265,2265,2265,2265,2265,2265,2265,2265,2265,2265,2265,2265,2215,2215,2215,2215,2215,2215,2215,2215,2215
2215,2215,2215,2215,2215,2215,2215,2215,2215,2215,2215,2215,2215,2215,2265,2265,2265,2265,2265,2265,2265,2265,2265,2265,2265,2265,2265,2265,2265,2265,2337,2337,2337,2337,2265,2265,2265,2265,2337,2337,2337,2337,2265,2265,2265,2265,2265,2265,2265,2265,2265,2265,2265,2265,2265,2265,2265,2265,2265,2265,2265,2215,2215,2215,2215,2215,2215,2215,2215,2215
2215,2215,2215,2215,2215,2215,2215,2215,2215,2215,2215,2215,2215,2215,2265,2265,2265,2265,2265,2265,2265,2265,2265,2265,2265,2265,2265,2265,2265,2265,2265,2265,2265,2265,2265,2265,2265,2265,2265,2265,2265,2265,2337,2265,2265,2265,2265,2265,2265,2265,2265,2265,2265,2265,2265,2265,2265,2265,2265,2265,2265,2215,2215,2215,2215,2215,2215,2215,2215,2215
2215,2215,2215,2215,2215,2215,2215,2215,2215,2215,2215,2215,2215,2215,2265,2265,2265,2265,2265,2265,2265,2265,2265,2265,2265,2265,2265,2265,2337,2265,2265,2265,2265,2265,2265,2265,2265,2265,2265,2265,2265,2265,2265,2337,2265,2265,2265,2265,2265,2265,2265,2265,2265,2265,2265,2265,2265,2265,2265,2265,2265,2215,2215,2215,2215,2215,2215,2215,2215,2215
2215,2215,2215,2215,2215,2215,2215,2215,2215,2215,2215,2215,2215,2215,2265,2265,2265,2265,2265,2265,2265,2265,2265,2265,2265,2265,2265,2337,2265,2265,2265,2265,2265,2265,2265,2265,2265,2265,2265,2265,2265,2265,2265,2265,2337,2265,2265,2265,2265,2265,2265,2265,2265,2265,2265,2265,2265,2265,2265,2265,2265,2215,2215,2215,2215,2215,2215,2215,2215,2215
2215,2215,2215,2215,2215,2215,2215,2215,2215,2215,2215,2215,2215,2215,2265,2265,2265,2265,2265,2265,2265,2265,2265,2265,2265,2265,2337,2265,2265,2265,2265,2265,2265,2265,2265,2265,2265,2265,2265,2265,2265,2265,2265,2265,2265,2265,2265,2265,2265,2265,2265,2265,2265,2265,2265,2265,2265,2265,2265,2265,2265,2215,2215,2215,2215,2215,2215,2215,2215,2215
2215,2215,2215,2215,2215,2215,2215,2215,2215,2215,2215,2215,2215,2215,2265,2265,2265,2265,2265,2265,2265,2265,2265,2265,2265,2337,2265,2265,2265,2265,2265,2265,2265,2265,2265,2265,2265,2265,2265,2265,2265,2265,2265,2265,2265,2265,2265,2265,2265,2265,2265,2265,2265,2265,2265,2265,2265,2265,2265,2265,2265,2215,2215,2215,2215,2215,2215,2215,2215,2215
2215,2215,2215,2215,2215,2215,2215,2215,2215,2215,2215,2215,2215,2215,2265,2265,2265,2265,2265,2265,2265,2265,2265,2265,2337,2265,2265,2265,2265,2265,2265,2265,2265,2265,2265,2265,2265,2265,2265,2265,2265,2265,2265,2265,2265,2265,2265,2265,2267,2265,2265,2265,2265,2265,2265,2265,2265,2265,2265,2265,2265,2215,2215,2215,2215,2215,2215,2215,2215,2215
2215,2215,2215,2215,2215,2215,2215,2215,2215,2215,2215,2215,2215,2215,2265,2265,2265,2265,2265,2265,2265,2265,2265,2265,2265,2265,2265,2265,2265,2265,2447,2265,2265,2265,2265,2265,2265,2265,2265,2265,2265,2447,2265,2265,2265,2265,2265,2265,2267,2265,2265,2265,2265,2265,2265,2265,2265,2265,2265,2265,2265,2215,2215,2215,2215,2215,2215,2215,2215,2215
2215,2215,2215,2215,2215,2215,2215,2215,2215,2215,2215,2215,2215,2215,2265,2265,2265,2265,2265,2265,2265,2265,2265,2265,2265,2265,2265,2265,2265,2265,2265,2265,2265,2265,2265,2265,2265,2265,2265,2265,2265,2265,2265,2265,2265,2265,2265,2265,2267,2265,2265,2265,2265,2265,2265,2265,2265,2265,2265,2265,2265,2215,2215,2215,2215,2215,2215,2215,2215,2215
2215,2215,2215,2215,2215,2215,2215,2215,2215,2215,2215,2215,2215,2215,2265,2265,2265,2265,2265,2265,2265,2265,2265,2265,2265,2265,2265,2265,2265,2265,2265,2265,2265,2265,2265,2265,2265,2265,2265,2265,2265,2265,2265,2265,2265,2265,2265,2265,2267,2265,2265,2265,2265,2265,2265,2265,2265,2265,2265,2265,2265,2215,2215,2215,2215,2215,2215,2215,2215,2215
2215,2215,2215,2215,2215,2215,2215,2215,2215,2215,2215,2215,2215,2215,2265,2265,2265,2265,2265,2265,2265,2265,2265,2265,2265,2265,2265,2265,2265,2265,2265,2265,2265,2265,2265,2265,2265,2265,2265,2265,2265,2265,2265,2265,2265,2265,2265,2265,2265,2265,2265,2265,2265,2265,2265,2265,2265,2265,2265,2265,2265,2215,2215,2215,2215,2215,2215,2215,2215,2215
2215,2215,2215,2215,2215,2215,2215,2215,2215,2215,2215,2215,2215,2215,2265,2265,2265,2265,2265,2265,2265,2265,2265,2265,2265,2265,2265,2265,2265,2265,2265,2265,2265,2265,2265,2265,2265,2265,2265,2265,2265,2265,2265,2265,2265,2265,2265,2265,2265,2265,2265,2265,2265,2265,2265,2265,2265,2265,2265,2265,2265,2215,2215,2215,2215,2215,2215,2215,2215,2215
2215,2215,2215,2215,2215,2215,2215,2215,2215,2215,2215,2215,2215,2215,2265,2265,2265,2265,2265,2265,2265,2265,2265,2265,2265,2265,2265,2265,2265,2265,2265,2265,2265,2265,2265,2265,2265,2265,2265,2265,2265,2265,2265,2265,2265,2265,2265,2265,2265,2265,2265,2265,2265,2265,2265,2265,2265,2265,2265,2265,2265,2215,2215,2215,2215,2215,2215,2215,2215,2215
2215,2215,2215,2215,2215,2215,2215,2215,2215,2215,2215,2215,2215,2215,2265,2265,2265,2265,2265,2265,2265,2265,2265,2265,2265,2265,2265,2265,2265,2265,2265,2265,2265,2265,2265,2265,2265,2265,2265,2265,2265,2265,2265,2265,2265,2265,2265,2265,2265,2265,2265,2265,2265,2265,2265,2265,2265,2265,2265,2265,2265,2215,2215,2215,2215,2215,2215,2215,2215,2215
2215,2215,2215,2215,2215,2215,2215,2215,2215,2215,2215,2215,2215,2215,2464,2265,2265,2265,2265,2265,2265,2265,2265,2215,2265,2265,2265,2265,2265,2265,2265,2265,2265,2265,2265,2265,2265,2265,2265,2265,2265,2265,2265,2265,2265,2265,2265,2265,2267,2265,2265,2265,2265,2265,2265,2265,2265,2265,2265,2265,2265,2215,2215,2215,2215,2215,2215,2215,2215,2215
2215,2215,2215,2215,2215,2215,2215,2215,2215,2215,2215,2215,2215,2215,2215,2464,2265,2265,2265,2265,2265,2265,2265,2215,2265,2265,2265,2265,2265,2265,2265,2265,2265,2265,2265,2265,2265,2265,2265,2265,2265,2265,2265,2265,2265,2265,2265,2265,2267,2265,2265,2265,2265,2265,2265,2265,2265,2265,2265,2265,2265,2215,2215,2215,2215,2215,2215,2215,2215,2215
2215,2215,2215,2215,2215,2215,2215,2215,2215,2215,2215,2215,2215,2215,2215,2215,2464,2265,2265,2265,2265,2265,2265,2215,2265,2265,2265,2265,2265,2265,2265,2265,2265,2265,2265,2265,2265,2265,2265,2265,2265,2265,2265,2265,2265,2265,2265,2265,2267,2265,2265,2265,2265,2265,2265,2265,2265,2265,2265,2265,2265,2215,2215,2215,2215,2215,2215,2215,2215,2215
2215,2215,2215,2215,2215,2215,2215,2215,2215,2215,2215,2215,2215,2215,2215,2215,2215,2464,2265,2265,2265,2265,2265,2215,2265,2265,2265,2265,2265,2265,2265,2265,2265,2265,2265,2265,2265,2265,2265,2265,2265,2265,2265,2265,2265,2265,2265,2265,2267,2265,2265,2265,2265,2265,2265,2265,2265,2265,2265,2265,2265,2215,2215,2215,2215,2215,2215,2215,2215,2215
2215,2215,2215,2215,2215,2215,2215,2215,2215,2215,2215,2215,2215,2215,2215,2215,2215,2215,2464,2265,2265,2265,2265,2215,2337,2265,2265,2265,2265,2265,2447,2265,2265,2265,2265,2265,2265,2265,2265,2265,2265,2447,2265,2265,2265,2265,2265,2337,2267,2265,2265,2265,2265,2265,2265,2265,2265,2265,2265,2265,2265,2215,2215,2215,2215,2215,2215,2215,2215,2215
2215,2215,2215,2215,2215,2215,2215,2215,2215,2215,2215,2215,2215,2215,2215,2215,2215,2215,2215,2265,2265,2265,2265,2265,2265,2337,2265,2265,2265,2265,2265,2265,2265,2265,2265,2265,2265,2265,2265,2265,2265,2265,2265,2265,2265,2265,2337,2215,2215,2215,2265,2265,2265,2265,2265,2265,2215,2215,2215,2215,2215,2215,2215,2215,2215,2215,2215,2215,2215,2215
2215,2215,2215,2215,2215,2215,2215,2215,2215,2215,2215,2215,2215,2215,2215,2215,2215,2215,2215,2265,2265,2265,2265,2265,2265,2265,2337,2265,2265,2265,2265,2265,2265,2265,2265,2265,2265,2265,2265,2265,2265,2265,2265,2265,2265,2337,2215,2215,2215,2215,2215,2215,2265,2265,2265,2265,2215,2215,2265,2265,2215,2215,2215,2215,2215,2215,2215,2215,2215,2215
2215,2215,2215,2215,2215,2215,2215,2215,2215,2215,2215,2215,2215,2215,2215,2215,2215,2464,2265,2265,2265,2265,2265,2265,2265,2265,2265,2265,2265,2265,2265,2265,2265,2265,2265,2265,2265,2265,2265,2265,2265,2265,2265,2265,2337,2215,2215,2215,2215,2215,2265,2265,2265,2265,2265,2265,2265,2265,2265,2265,2215,2215,2215,2215,2215,2215,2215,2215,2215,2215
2215,2215,2215,2215,2215,2215,2215,2215,2215,2215,2215,2215,2215,2215,2215,2215,2464,2265,2265,2265,2265,2265,2265,2265,2265,2265,2265,2265,2337,2265,2265,2265,2265,2265,2265,2265,2265,2265,2265,2265,2265,2265,2265,2337,2265,2265,2265,2265,2265,2265,2265,2265,2265,2265,2265,2265,2265,2265,2265,2265,2215,2215,2215,2215,2215,2215,2215,2215,2215,2215
2215,2215,2215,2215,2215,2215,2215,2215,2215,2215,2215,2215,2215,2215,2215,2215,2265,2265,2265,2265,2265,2265,2265,2265,2265,2265,2265,2265,2265,2337,2265,2265,2265,2265,2265,2265,2265,2265,2265,2265,2265,2265,2337,2265,2265,2265,2265,2265,2265,2265,2265,2265,2265,2265,2265,2265,2265,2265,2265,2265,2215,2215,2215,2215,2215,2215,2215,2215,2215,2215
2215,2215,2215,2215,2215,2215,2215,2215,2215,2215,2215,2215,2215,2215,2215,2215,2265,2265,2265,2265,2265,2265,2265,2265,2265,2265,2265,2265,2265,2265,2337,2337,2337,2265,2265,2265,2265,2265,2337,2337,2337,2337,2265,2265,2265,2265,2265,2265,2265,2265,2265,2265,2265,2265,2265,2265,2265,2265,2265,2265,2215,2215,2215,2215,2215,2215,2215,2215,2215,2215
2215,2215,2215,2215,2215,2215,2215,2215,2215,2215,2215,2215,2215,2215,2215,2215,2265,2265,2265,2265,2265,2265,2265,2265,2265,2265,2265,2265,2265,2265,2215,2215,2265,2265,2265,2265,2265,2337,2265,2215,2215,2215,2265,2265,2265,2265,2265,2265,2265,2265,2265,2265,2265,2265,2265,2265,2265,2265,2265,2265,2215,2215,2215,2215,2215,2215,2215,2215,2215,2215
2215,2215,2215,2215,2215,2215,2215,2215,2215,2215,2215,2215,2215,2215,2215,2215,2265,2265,2265,2265,2265,2265,2265,2265,2265,2265,2265,2265,2265,2265,2215,2215,2265,2265,2265,2265,2265,2265,2265,2215,2215,2215,2265,2265,2265,2265,2265,2265,2265,2265,2265,2265,2265,2265,2265,2265,2265,2265,2265,2265,2215,2215,2215,2215,2215,2215,2215,2215,2215,2215
2215,2215,2215,2215,2215,2215,2215,2215,2215,2215,2215,2215,2215,2215,2215,2215,2265,2265,2265,2265,2265,2265,2265,2265,2265,2265,2265,2265,2265,2265,2269,2271,2265,2265,2265,2265,2265,2265,2265,2269,2424,2271,2265,2265,2265,2265,2265,2265,2265,2265,2265,2265,2265,2265,2265,2265,2265,2265,2265,2265,2215,2215,2215,2215,2215,2215,2215,2215,2215,2215
2215,2215,2215,2215,2215,2215,2215,2215,2215,2215,2215,2215,2215,2215,2215,2215,2265,2265,2265,2265,2265,2265,2265,2265,2265,2265,2265,2265,2265,2265,2265,2265,2265,2265,2265,2265,2265,2265,2265,2265,2265,2265,2265,2265,2265,2265,2265,2265,2265,2265,2265,2265,2265,2265,2265,2265,2265,2265,2265,2265,2215,2215,2215,2215,2215,2215,2215,2215,2215,2215
2215,2215,2215,2215,2215,2215,2215,2215,2215,2215,2215,2215,2215,2215,2215,2215,2265,2265,2265,2265,2265,2265,2265,2265,2265,2265,2265,2265,2265,2265,2265,2265,2265,2265,2265,2265,2265,2265,2265,2265,2265,2265,2265,2265,2265,2265,2265,2265,2265,2265,2265,2265,2265,2265,2265,2265,2265,2265,2265,2265,2215,2215,2215,2215,2215,2215,2215,2215,2215,2215
2215,2215,2215,2215,2215,2215,2215,2215,2215,2215,2215,2215,2215,2215,2215,2215,2265,2265,2265,2265,2265,2265,2265,2265,2265,2265,2265,2265,2265,2265,2265,2265,2265,2265,2265,2265,2265,2265,2265,2265,2265,2265,2265,2265,2265,2265,2265,2265,2265,2265,2265,2265,2265,2265,2265,2265,2265,2265,2265,2265,2215,2215,2215,2215,2215,2215,2215,2215,2215,2215
2215,2215,2215,2215,2215,2215,2215,2215,2215,2215,2215,2215,2215,2215,2215,2267,2267,2267,2267,2265,2265,2265,2265,2265,2265,2265,2265,2265,2265,2265,2424,2424,2265,2265,2265,2265,2265,2265,2265,2424,2424,2424,2265,2265,2265,2265,2265,2265,2265,2265,2265,2265,2265,2265,2265,2265,2265,2265,2265,2265,2215,2215,2215,2215,2215,2215,2215,2215,2215,2215
2215,2215,2215,2215,2215,2215,2215,2215,2215,2215,2215,2215,2215,2215,2215,2267,2267,2267,2267,2424,2424,2265,2265,2265,2464,2265,2265,2265,2265,2215,2215,2215,2265,2265,2265,2265,2265,2265,2265,2215,2215,2215,2424,2424,2265,2265,2265,2265,2265,2269,2265,2265,2265,2265,2265,2265,2265,2265,2424,2424,2215,2215,2215,2215,2215,2215,2215,2215,2215,2215
2215,2215,2215,2215,2215,2215,2215,2215,2215,2215,2215,2215,2215,2215,2215,2215,2265,2265,2265,2265,2265,2265,2265,2265,2267,2265,2265,2265,2265,2215,2215,2215,2424,2271,2265,2265,2265,2269,2424,2215,2215,2215,2215,2215,2265,2265,2265,2265,2265,2215,2265,2265,2265,2265,2265,2265,2265,2265,2265,2215,2215,2215,2215,2215,2215,2215,2215,2215,2215,2215
2215,2215,2215,2215,2215,2215,2215,2215,2215,2215,2215,2215,2215,2215,2215,2215,2265,2265,2265,2265,2265,2265,2265,2265,2462,2265,2265,2265,2265,2215,2215,2215,2215,2215,2265,2265,2265,2215,2215,2215,2215,2215,2215,2215,2265,2265,2265,2265,2265,2265,2265,2265,2265,2265,2265,2265,2265,2265,2265,2265,2215,2215,2215,2215,2215,2215,2215,2215,2215,2215
2215,2215,2215,2215,2215,2215,2215,2215,2215,2215,2215,2215,2215,2215,2215,2215,2464,2265,2265,2265,2265,2265,2265,2265,2265,2265,2265,2265,2265,2215,2215,2215,2424,2271,2265,2265,2265,2269,2424,2215,2215,2215,2215,2215,2265,2265,2265,2265,2265,2265,2265,2265,2265,2265,2265,2265,2265,2265,2265,2265,2265,2215,2215,2215,2215,2215,2215,2215,2215,2215
2215,2215,2215,2215,2215,2215,2215,2215,2215,2215,2215,2215,2215,2215,2215,2215,2215,2464,2265,2265,2265,2265,2265,2265,2265,2265,2265,2265,2265,2215,2215,2215,2265,2447,2265,2265,2265,2447,2265,2215,2215,2215,2215,2215,2265,2265,2265,2265,2265,2265,2265,2265,2265,2265,2265,2265,2265,2265,2265,2265,2265,2215,2215,2215,2215,2215,2215,2215,2215,2215
2215,2215,2215,2215,2215,2215,2215,2215,2215,2215,2215,2215,2215,2215,2215,2215,2215,2215,2464,2265,2265,2265,2265,2265,2265,2265,2265,2265,2265,2215,2215,2215,2265,2265,2265,2265,2265,2265,2265,2215,2215,2215,2215,2215,2265,2265,2265,2265,2265,2265,2265,2265,2265,2265,2265,2265,2265,2265,2265,2265,2265,2215,2215,2215,2215,2215,2215,2215,2215,2215
2215,2215,2215,2215,2215,2215,2215,2215,2215,2215,2215,2215,2215,2215,2215,2215,2215,2215,2215,2464,2464,2424,2424,2424,2424,2424,2424,2424,2424,2215,2215,2215,2265,2265,2210,2211,2212,2265,2265,2215,2215,2215,2215,2215,2424,2424,2265,2265,2265,2265,2265,2265,2265,2424,2424,2424,2424,2424,2424,2424,2424,2215,2215,2215,2215,2215,2215,2215,2215,2215
2215,2215,2215,2215,2215,2215,2215,2215,2215,2215,2215,2215,2215,2215,2215,2215,2215,2215,2215,2215,2215,2215,2215,2215,2215,2215,2215,2215,2215,2215,2215,2215,2265,2265,2223,2224,2225,2265,2265,2215,2215,2215,2215,2215,2215,2215,2424,2424,2424,2424,2424,2424,2424,2215,2215,2215,2215,2215,2215,2215,2215,2215,2215,2215,2215,2215,2215,2215,2215,2215
2215,2215,2215,2215,2215,2215,2215,2215,2215,2215,2215,2215,2215,2215,2215,2215,2215,2215,2215,2462,2424,2424,2424,2424,2424,2425,2215,2215,2215,2215,2215,2215,2265,2265,2236,2237,2238,2265,2265,2215,2215,2215,2215,2215,2215,2215,2215,2215,2215,2215,2215,2215,2215,2215,2215,2215,2215,2215,2215,2215,2215,2215,2215,2215,2215,2215,2215,2215,2215,2215
2215,2215,2215,2215,2215,2215,2215,2215,2215,2215,2215,2215,2215,2215,2215,2215,2215,2215,2215,2265,2265,2265,2265,2265,2265,2265,2265,2265,2265,2265,2265,2265,2265,2265,2265,2265,2265,2265,2265,2265,2265,2265,2265,2265,2265,2265,2265,2265,2265,2265,2265,2265,2215,2215,2215,2215,2215,2215,2215,2215,2215,2215,2215,2215,2215,2215,2215,2215,2215,2215
2215,2215,2215,2215,2215,2215,2215,2215,2215,2215,2215,2215,2215,2215,2215,2215,2215,2215,2215,2265,2265,2265,2265,2265,2265,2265,2265,2265,2265,2265,2265,2265,2265,2265,2265,2265,2265,2265,2265,2210,2211,2212,2265,2265,2265,2265,2265,2265,2265,2265,2265,2265,2215,2215,2215,2215,2215,2215,2215,2215,2215,2215,2215,2215,2215,2215,2215,2215,2215,2215
2215,2215,2215,2215,2215,2215,2215,2215,2215,2215,2215,2215,2215,2215,2215,2215,2215,2215,2215,2265,2265,2265,2210,2211,2212,2265,2265,2265,2265,2265,2265,2265,2265,2265,2265,2265,2265,2265,2265,2223,2224,2225,2265,2265,2265,2265,2265,2262,2263,2265,2265,2265,2215,2215,2215,2215,2215,2215,2215,2215,2215,2215,2215,2215,2215,2215,2215,2215,2215,2215
2215,2215,2215,2215,2215,2215,2215,2215,2215,2215,2215,2215,2215,2215,2215,2215,2215,2215,2215,2265,2265,2265,2223,2224,2225,2265,2265,2265,2265,2265,2265,2265,2265,2265,2265,2265,2265,2265,2265,2236,2237,2238,2265,2265,2265,2265,2265,2275,2276,2265,2265,2265,2215,2215,2215,2215,2215,2215,2215,2215,2215,2215,2215,2215,2215,2215,2215,2215,2215,2215
2215,2215,2215,2215,2215,2215,2215,2215,2215,2215,2215,2215,2215,2215,2215,2215,2215,2215,2215,2265,2265,2265,2236,2237,2238,2265,2265,2265,2265,2262,2263,2265,2265,2265,2265,2265,2265,2265,2265,2265,2265,2265,2265,2265,2265,2265,2265,2265,2265,2265,2265,2265,2215,2215,2215,2215,2215,2215,2215,2215,2215,2215,2215,2215,2215,2215,2215,2215,2215,2215
2215,2215,2215,2215,2215,2215,2215,2215,2215,2215,2215,2215,2215,2215,2215,2215,2215,2215,2215,2265,2265,2265,2265,2265,2265,2265,2265,2265,2265,2275,2276,2265,2265,2265,2265,2265,2265,2265,2265,2265,2265,2265,2265,2265,2265,2265,2265,2265,2265,2265,2265,2265,2215,2215,2215,2215,2215,2215,2215,2215,2215,2215,2215,2215,2215,2215,2215,2215,2215,2215
2215,2215,2215,2215,2215,2215,2215,2215,2215,2215,2215,2215,2215,2215,2215,2215,2215,2215,2215,2265,2265,2265,2265,2265,2265,2265,2265,2265,2265,2265,2265,2265,2265,2265,2265,2265,2265,2265,2265,2262,2263,2265,2265,2265,2265,2265,2265,2265,2265,2265,2265,2265,2215,2215,2215,2215,2215,2215,2215,2215,2215,2215,2215,2215,2215,2215,2215,2215,2215,2215
2215,2215,2215,2215,2215,2215,2215,2215,2215,2215,2215,2215,2215,2215,2215,2215,2215,2215,2215,2265,2265,2265,2265,2265,2265,2265,2265,2265,2265,2265,2265,2265,2265,2265,2265,2265,2265,2265,2265,2275,2276,2265,2265,2265,2265,2265,2265,2265,2265,2265,2265,2265,2215,2215,2215,2215,2215,2215,2215,2215,2215,2215,2215,2215,2215,2215,2215,2215,2215,2215
2215,2215,2215,2215,2215,2215,2215,2215,2215,2215,2215,2215,2215,2215,2215,2215,2215,2215,2215,2265,2265,2265,2265,2265,2265,2265,2265,2265,2265,2265,2265,2265,2265,2265,2265,2265,2265,2265,2265,2265,2265,2265,2265,2265,2265,2265,2265,2265,2265,2265,2265,2265,2215,2215,2215,2215,2215,2215,2215,2215,2215,2215,2215,2215,2215,2215,2215,2215,2215,2215
2215,2215,2215,2215,2215,2215,2215,2215,2215,2215,2215,2215,2215,2215,2215,2215,2215,2215,2215,2215,2215,2215,2215,2215,2215,2215,2215,2215,2215,2215,2215,2215,2215,2271,2431,2432,2265,2269,2215,2215,2215,2215,2215,2215,2215,2215,2215,2215,2215,2215,2215,2215,2215,2215,2215,2215,2215,2215,2215,2215,2215,2215,2215,2215,2215,2215,2215,2215,2215,2215
2215,2215,2215,2215,2215,2215,2215,2215,2215,2215,2215,2215,2215,2215,2215,2215,2215,2215,2215,2215,2215,2215,2215,2215,2215,2215,2215,2215,2215,2215,2215,2215,2215,2215,2444,2444,2445,2215,2215,2215,2215,2215,2215,2215,2215,2215,2215,2215,2215,2215,2215,2215,2215,2215,2215,2215,2215,2215,2215,2215,2215,2215,2215,2215,2215,2215,2215,2215,2215,2215
2215,2215,2215,2215,2215,2215,2215,2215,2215,2215,2215,2215,2215,2215,2215,2215,2215,2215,2215,2215,2215,2215,2215,2215,2215,2215,2215,2215,2215,2215,2215,2215,2215,2215,2444,2444,2445,2215,2215,2215,2215,2215,2215,2215,2215,2215,2215,2215,2215,2215,2215,2215,2215,2215,2215,2215,2215,2215,2215,2215,2215,2215,2215,2215,2215,2215,2215,2215,2215,2215
2215,2215,2215,2215,2215,2215,2215,2215,2215,2215,2215,2215,2215,2215,2215,2215,2215,2215,2215,2215,2215,2215,2215,2215,2215,2215,2215,2215,2215,2215,2215,2215,2215,2215,2457,2457,2458,2215,2215,2215,2215,2215,2215,2215,2215,2215,2215,2215,2215,2215,2215,2215,2215,2215,2215,2215,2215,2215,2215,2215,2215,2215,2215,2215,2215,2215,2215,2215,2215,2215
2215,2215,2215,2215,2215,2215,2215,2215,2215,2215,2215,2215,2215,2215,2215,2215,2215,2215,2215,2215,2215,2215,2215,2215,2215,2215,2215,2215,2215,2215,2215,2215,2215,2215,145,145,131,2215,2215,2215,2215,2215,2215,2215,2215,2215,2215,2215,2215,2215,2215,2215,2215,2215,2215,2215,2215,2215,2215,2215,2215,2215,2215,2215,2215,2215,2215,2215,2215,2215
2215,2215,2215,2215,2215,2215,2215,2215,2215,2215,2215,2215,2215,2215,2215,2215,2215,2215,2215,2215,2215,2215,2215,2215,2215,2215,2215,2215,2215,2215,2215,2215,2215,2215,2265,2265,2265,2215,2215,2215,2215,2215,2215,2215,2215,2215,2215,2215,2215,2215,2215,2215,2215,2215,2215,2215,2215,2215,2215,2215,2215,2215,2215,2215,2215,2215,2215,2215,2215,2215
2215,2215,2215,2215,2215,2215,2215,2215,2215,2215,2215,2215,2215,2215,2215,2215,2215,2215,2215,2215,2215,2215,2215,2215,2215,2215,2215,2215,2215,2215,2215,2215,2215,2215,2265,2265,2265,2215,2215,2215,2215,2215,2215,2215,2215,2215,2215,2215,2215,2215,2215,2215,2215,2215,2215,2215,2215,2215,2215,2215,2215,2215,2215,2215,2215,2215,2215,2215,2215,2215
2215,2215,2215,2215,2215,2215,2215,2215,2215,2215,2215,2215,2215,2215,2215,2215,2215,2215,2215,2215,2215,2215,2215,2215,2215,2215,2215,2215,2215,2215,2215,2215,2215,2215,2265,2265,2265,2215,2215,2215,2215,2215,2215,2215,2215,2215,2215,2215,2215,2215,2215,2215,2215,2215,2215,2215,2215,2215,2215,2215,2215,2215,2215,2215,2215,2215,2215,2215,2215,2215
