58 59 59 59 58 58 59 59 58 59 59 59 59 58 58 58 58 59 59 59 58 58 59 59 59 58 59 59 58 59 58 58 59 58 59 59 58 58 58 58 58 58 59 58 58 59 58 58 58 59 58 58 58 58 58 58 59 58 59 58 58 59 58 59 58 59 58 59 58 58 58 58 58 59 59 58 58 58 59 59 58 59 58 59 58 59 58 59 58 58 58 58 59 58 58 59 59 58 59 59
58 59 59 59 59 59 58 59 58 58 59 59 58 59 58 58 59 58 58 59 59 58 59 59 59 58 59 59 59 59 58 58 58 59 59 59 58 58 58 58 58 58 58 58 58 58 58 59 59 59 59 59 59 59 59 59 59 59 59 59 59 59 59 59 58 59 58 59 58 59 58 59 58 59 58 59 58 59 58 59 58 59 58 59 58 59 58 59 58 59 58 59 58 59 58 59 58 59 58 58
58 58 30 28 28 28 45 58 59 59 58 59 59 59 58 59 58 59 58 58 58 59 59 58 40 42 59 59 59 59 59 58 58 59 59 59 58 58 58 58 58 58 58 58 58 58 58 58 58 58 58 58 58 58 58 58 59 58 58 58 58 58 58 58 58 59 58 59 58 59 58 59 58 59 58 59 58 59 58 59 58 59 58 59 58 59 58 59 58 59 58 59 58 59 58 59 58 59 58 58
59 59 16 4 4 4 27 28 28 28 28 28 28 28 28 28 28 28 28 28 28 28 28 28 28 45 59 58 59 58 58 58 59 59 58 58 59 40 15 42 43 41 30 28 28 28 28 28 28 28 28 28 28 28 28 28 28 28 28 28 28 28 28 28 28 28 28 28 28 28 28 28 28 28 28 28 28 28 28 28 28 28 28 28 28 28 28 28 28 28 28 45 58 59 15 43 41 41 41 58
59 59 16 4 4 4 4 4 4 4 4 4 4 4 4 4 4 4 4 4 4 4 4 4 4 14 58 59 59 58 59 58 59 59 59 58 58 43 41 43 41 15 16 4 4 4 4 4 4 4 4 4 4 4 4 4 4 4 4 4 4 4 4 4 4 4 4 4 4 4 4 4 4 4 4 4 4 4 4 4 4 4 4 4 4 4 4 4 4 4 4 14 58 59 43 43 15 40 40 58
58 59 16 4 4 4 1 2 2 2 2 2 2 2 2 2 2 2 2 2 2 2 2 3 4 14 59 59 58 59 59 59 58 59 58 58 59 42 43 43 41 42 16 4 1 2 2 2 2 2 2 2 2 2 2 2 2 3 4 1 2 2 2 2 2 2 2 2 2 2 2 2 2 2 2 2 2 2 2 2 2 2 2 2 2 2 2 2 2 3 4 14 58 59 42 42 40 43 43 58
59 58 44 2 2 2 17 58 58 58 58 59 59 58 58 58 58 59 59 58 59 58 58 16 4 14 59 58 58 58 58 59 59 58 58 59 59 40 41 41 43 43 41 15 43 42 41 15 15 43 58 58 58 58 59 59 58 16 4 14 41 41 15 40 42 43 15 40 41 40 42 42 43 41 40 43 15 41 15 15 41 40 15 42 40 15 40 42 43 16 4 14 58 59 43 40 43 41 41 58
59 59 58 59 58 59 58 58 58 59 58 59 58 58 58 58 58 58 58 59 59 59 58 16 4 14 59 58 58 59 59 58 58 58 59 59 58 58 59 59 58 15 41 42 15 40 42 15 59 59 59 58 58 58 59 58 59 16 4 14 43 15 40 41 40 59 58 58 58 58 58 58 59 59 59 58 58 58 58 59 59 59 58 59 59 59 59 43 40 16 4 14 58 59 42 40 15 42 41 58
59 59 58 59 59 58 59 58 58 59 58 58 59 58 59 58 59 58 59 58 58 58 58 16 4 14 59 59 59 5 6 7 58 59 58 59 59 59 59 59 59 43 40 43 43 43 41 41 59 58 58 59 58 59 58 59 58 16 4 14 40 59 59 58 58 59 59 59 59 58 59 59 59 58 58 58 59 59 59 59 59 58 58 58 59 59 58 41 43 16 4 14 58 59 43 42 41 41 41 58
58 59 58 58 59 59 58 58 59 58 58 58 58 58 59 58 58 58 59 59 59 58 58 16 4 14 59 59 59 18 19 20 58 59 59 58 58 41 42 40 41 41 43 43 43 41 15 43 59 59 59 58 58 58 58 58 58 16 4 14 40 58 58 59 59 59 59 58 58 59 58 58 58 58 58 59 59 58 58 59 59 59 58 59 58 58 58 42 40 16 4 14 58 59 42 41 58 59 58 59
59 59 58 59 58 59 58 59 58 58 58 58 58 59 58 58 59 58 58 59 58 58 59 16 4 14 59 58 58 31 32 33 59 59 59 58 58 40 40 15 58 59 58 59 58 58 59 58 58 58 59 59 58 59 58 59 58 16 4 14 40 59 58 59 59 59 59 58 59 59 59 59 59 58 58 59 59 59 58 58 59 59 58 59 59 58 59 40 42 16 4 14 58 59 15 43 58 59 58 59
58 58 58 58 59 59 58 59 59 58 58 59 59 59 59 59 58 58 59 58 59 58 58 16 4 14 58 58 58 58 58 58 59 58 58 59 58 41 40 43 43 42 15 41 43 42 40 41 58 58 59 59 58 58 58 59 59 16 4 14 40 59 58 59 5 6 7 59 59 58 58 58 58 59 59 59 58 59 58 58 59 58 59 58 59 58 59 43 43 16 4 14 58 59 40 41 42 40 43 59
59 58 58 58 58 59 59 58 59 58 59 58 58 58 58 58 59 59 58 59 58 59 59 16 4 14 58 58 59 58 58 59 59 59 58 59 59 59 59 40 41 15 15 43 41 43 43 42 59 59 59 58 58 58 59 58 59 16 4 14 42 59 59 59 18 19 20 58 58 58 58 59 59 59 58 59 58 59 58 59 58 59 58 59 58 58 59 40 15 16 4 14 58 59 15 41 40 40 40 59
59 58 58 59 58 58 58 58 59 58 58 30 28 28 28 28 28 28 28 28 28 28 28 29 4 14 59 58 58 58 58 58 58 58 58 58 58 58 59 15 43 43 40 40 41 43 40 15 59 59 59 59 58 58 58 58 58 16 4 14 40 58 58 58 31 32 33 59 58 59 58 58 58 59 59 58 58 58 59 58 59 58 59 59 58 58 59 43 41 16 4 14 58 59 42 42 42 43 42 58
58 59 59 59 58 59 58 58 59 59 58 16 4 4 4 4 4 4 4 4 4 4 4 4 4 14 59 58 59 59 58 58 59 59 58 59 59 58 58 58 59 59 59 59 58 59 59 40 58 58 59 58 59 59 58 58 58 16 4 14 40 59 58 58 59 58 59 58 59 58 59 58 58 58 58 59 58 58 58 59 58 58 58 58 58 59 59 41 15 16 4 14 58 59 40 41 15 41 42 58
58 59 59 59 58 58 58 58 59 58 59 16 4 1 2 2 2 2 2 2 2 2 2 2 2 17 59 58 58 59 59 59 58 58 58 59 59 43 43 41 59 58 58 59 58 58 59 43 59 59 59 59 58 58 58 59 59 16 4 14 41 59 58 58 58 59 59 58 59 59 58 58 59 59 59 59 59 59 59 58 59 59 58 58 58 59 58 15 42 16 4 14 58 59 42 42 15 42 42 58
59 59 59 58 59 58 58 58 58 59 59 16 4 14 58 59 58 59 58 59 58 59 59 59 59 59 58 59 58 58 59 59 59 58 58 58 59 41 41 15 41 41 41 40 40 41 15 41 59 59 58 59 58 58 58 58 41 16 4 14 43 59 58 59 58 58 58 58 59 58 59 58 59 58 59 59 58 59 59 58 59 58 58 59 59 59 59 41 43 16 4 14 58 59 15 41 40 42 42 59
58 58 59 58 59 58 58 59 59 59 58 16 4 14 59 59 58 59 58 58 59 58 58 58 59 59 59 58 59 58 59 58 58 59 59 59 58 40 43 59 58 59 58 59 59 58 58 58 58 59 58 58 58 58 59 58 40 16 4 14 15 59 59 58 59 59 59 58 59 59 58 59 59 59 58 59 59 59 59 58 58 59 58 59 59 59 58 15 42 16 4 14 58 59 40 40 41 15 42 58
58 59 59 59 58 59 58 58 58 59 59 16 4 14 58 59 58 58 59 58 58 59 59 59 58 58 58 59 58 59 58 58 58 58 58 59 58 41 41 59 59 59 58 59 58 58 59 58 58 59 59 59 59 59 58 58 43 16 4 14 40 59 58 59 59 59 58 59 58 58 59 59 58 59 59 58 59 59 58 59 58 58 59 58 59 58 41 43 41 16 4 14 58 59 58 59 58 59 41 58
58 59 58 59 59 59 59 59 58 59 59 16 4 14 59 58 58 59 59 58 59 59 59 58 59 58 58 59 59 58 59 59 59 58 58 58 58 40 15 40 43 40 41 42 42 43 43 42 58 58 58 58 58 59 58 59 42 16 4 14 15 59 58 58 59 58 58 59 58 59 58 59 58 59 58 59 58 58 58 58 58 58 58 58 59 58 43 41 40 41 40 42 43 58 58 59 58 59 41 58
6 7 59 59 59 58 59 58 58 59 58 16 4 14 58 58 58 58 59 58 59 58 58 58 58 58 59 58 58 59 59 59 58 59 58 58 59 40 43 43 43 42 41 40 15 42 42 43 59 59 59 58 59 59 58 59 15 16 4 14 15 59 58 59 58 58 59 59 59 59 59 59 58 58 59 59 58 58 59 59 59 59 58 59 58 58 42 15 43 41 42 40 42 58 40 15 40 43 42 58
19 20 59 59 58 59 58 59 59 59 59 16 4 14 59 59 58 58 59 58 59 58 59 59 58 59 58 59 58 58 59 59 59 58 58 59 59 43 42 42 40 43 43 43 40 42 40 15 59 59 59 59 59 58 58 59 42 16 4 14 40 58 58 58 58 58 58 58 59 59 59 59 59 59 58 58 59 59 59 59 59 58 59 59 59 58 15 40 42 41 40 42 43 58 41 42 15 42 43 58
19 20 59 59 59 58 59 59 59 59 58 16 4 14 58 58 59 58 58 58 59 59 58 59 59 58 59 58 59 58 59 58 59 58 59 59 59 59 59 59 40 15 42 42 42 43 43 42 59 59 59 59 58 58 58 59 15 16 4 14 41 59 59 58 59 59 59 59 58 58 58 58 59 59 59 58 59 59 59 58 59 59 58 58 58 59 40 15 43 58 59 58 59 58 15 42 40 41 42 59
19 20 58 59 58 58 59 59 58 59 58 16 4 14 58 59 59 59 58 58 58 59 58 58 58 59 58 58 58 59 59 58 59 58 59 59 59 58 59 58 59 59 59 59 59 59 58 59 59 58 59 58 58 59 59 59 42 16 4 14 43 58 59 59 59 58 58 59 58 58 58 59 59 59 58 58 58 59 58 58 59 58 58 58 59 58 42 40 15 58 59 58 59 58 43 42 40 40 40 59
19 20 58 58 59 58 59 58 59 58 58 16 4 14 59 59 59 58 58 58 58 58 59 59 59 59 58 59 59 58 59 58 59 59 59 58 59 58 58 59 59 58 58 58 59 59 58 58 59 59 58 59 59 58 58 59 42 16 4 14 42 59 59 58 58 58 58 59 59 59 59 58 59 58 59 58 59 59 59 58 58 58 59 58 59 59 41 42 40 43 43 41 42 41 41 15 42 43 43 58
19 20 59 59 59 59 58 58 59 59 58 16 4 14 59 59 58 59 59 58 58 59 58 58 59 58 59 58 58 58 59 59 59 58 59 58 59 59 58 58 59 59 58 58 58 59 58 58 59 59 59 59 59 58 59 58 40 16 4 14 42 58 58 58 58 59 58 59 59 58 58 59 59 59 58 59 59 59 59 58 58 59 58 59 58 59 41 40 42 40 41 40 42 40 42 15 43 41 42 58
19 20 59 58 58 58 59 59 59 59 59 16 4 14 58 58 58 58 59 59 59 59 58 59 58 58 59 59 58 59 58 59 59 59 59 58 58 59 58 59 59 59 59 58 58 59 59 59 58 59 59 59 58 59 58 58 40 16 4 14 15 58 59 58 59 58 58 58 59 59 59 58 59 58 58 58 59 58 58 58 58 58 59 58 58 59 40 41 15 42 15 43 43 41 42 43 41 40 15 58
19 20 59 59 59 58 59 59 58 59 58 16 4 14 58 59 58 58 59 59 58 59 59 59 58 58 59 59 59 58 59 59 58 58 58 58 58 58 59 58 59 58 59 59 59 58 58 59 59 58 58 58 59 58 58 59 40 16 4 14 42 58 58 58 58 58 58 59 59 58 58 58 59 58 58 58 58 59 58 58 58 59 59 58 58 58 15 40 42 43 43 43 43 41 40 41 43 40 43 59
32 33 58 59 59 58 59 58 59 58 58 16 4 14 59 58 59 58 59 59 59 59 58 58 59 59 58 59 59 58 59 59 59 59 58 58 59 59 58 59 59 58 58 59 59 58 59 58 58 59 59 58 59 58 58 59 42 16 4 14 42 59 59 58 58 59 58 58 59 58 59 58 58 59 59 58 59 58 58 58 59 59 59 59 59 58 59 58 59 58 59 58 59 58 59 58 59 58 59 58
58 59 58 58 59 58 58 58 59 59 59 16 4 14 59 59 58 59 59 58 58 59 59 58 59 59 58 58 59 58 59 59 59 59 59 58 58 59 58 59 59 58 58 58 58 59 59 58 58 59 59 59 58 59 58 59 42 16 4 14 43 58 58 59 58 58 59 59 59 59 58 58 58 59 58 59 59 58 58 58 58 58 58 58 58 58 59 58 59 58 59 58 59 58 59 58 59 58 59 58
58 58 58 59 59 59 58 58 59 58 58 16 4 14 58 58 59 58 59 58 59 59 58 59 58 59 59 59 58 58 59 58 59 58 58 58 58 58 58 59 59 58 58 59 58 59 58 59 59 59 59 59 58 58 58 59 40 16 4 14 43 59 59 59 59 58 58 58 58 59 59 59 59 58 59 59 59 58 59 59 59 59 58 59 59 58 59 58 59 58 59 58 59 58 59 58 59 58 59 58
58 58 59 58 59 59 59 58 59 59 59 16 4 14 58 58 59 58 58 59 58 59 58 59 59 59 59 59 58 58 59 59 58 59 59 59 58 59 59 58 58 58 15 15 15 15 43 58 58 59 59 59 59 59 58 59 15 16 4 14 40 59 59 59 58 59 59 42 40 15 42 42 40 15 41 42 15 43 43 42 40 43 42 40 40 58 59 58 59 58 59 58 59 58 59 58 59 58 59 58
59 58 59 58 58 59 59 58 58 58 59 16 4 14 59 58 59 58 59 59 58 58 59 58 58 59 59 58 59 58 59 59 59 59 58 59 59 59 59 58 43 42 42 40 40 41 41 40 59 59 58 58 59 59 59 59 42 16 4 14 43 15 43 40 43 43 15 15 42 15 40 15 43 40 15 42 43 42 42 15 41 42 15 40 42 58 59 58 59 58 59 58 59 58 59 58 59 58 59 58
58 59 59 58 58 59 59 59 58 59 59 16 4 27 28 28 28 28 28 28 28 28 28 28 28 28 28 28 28 28 28 28 28 28 28 28 28 28 28 28 43 40 15 15 42 43 42 40 58 58 59 58 59 59 59 58 28 29 4 27 28 28 28 28 28 28 28 28 28 28 28 28 28 28 28 28 28 28 28 28 28 28 28 40 15 43 58 59 58 59 58 59 58 59 58 59 58 59 58 59
58 58 58 59 58 59 59 58 58 58 59 16 4 4 4 4 4 4 4 4 4 4 4 4 4 4 4 4 4 4 4 4 4 4 4 4 4 4 4 4 15 40 41 40 42 43 40 15 54 4 4 4 4 4 4 4 4 4 4 4 4 4 4 4 4 4 4 4 4 4 4 4 4 4 4 4 4 4 4 4 4 4 4 40 41 42 58 59 58 59 58 59 58 59 58 59 58 59 58 59
58 59 58 58 58 59 59 58 59 58 58 44 2 2 2 2 2 2 2 2 2 2 2 2 2 2 2 2 2 2 2 2 2 2 2 2 2 2 2 2 40 15 15 40 15 40 40 42 58 58 58 59 59 59 58 2 2 3 4 1 2 2 58 58 58 58 58 58 59 59 59 41 43 42 40 41 41 41 40 15 40 41 4 41 42 40 58 59 58 59 58 59 58 59 58 59 58 59 58 58
58 58 58 58 59 58 58 58 58 58 58 59 58 58 58 59 58 59 58 59 59 59 59 58 58 58 58 59 59 58 58 59 59 59 59 59 59 58 58 58 40 15 43 41 41 42 40 40 59 58 58 58 58 59 58 41 15 40 2 43 40 41 58 58 59 58 58 59 59 58 58 15 15 15 15 40 15 42 40 43 42 42 4 42 40 40 58 59 58 59 58 59 58 59 58 59 58 59 58 58
59 58 59 58 58 58 58 59 59 59 58 59 59 58 59 59 58 59 59 58 58 59 59 58 58 59 59 59 58 59 58 59 58 58 59 58 59 58 59 58 41 42 42 42 43 43 41 43 58 58 59 59 59 58 59 15 41 40 43 41 40 42 58 59 58 59 59 59 59 59 59 58 59 58 59 58 58 58 59 59 59 41 4 40 40 40 58 59 58 59 58 59 58 59 58 59 58 59 58 58
59 58 59 58 58 58 58 59 58 59 58 58 59 59 58 59 58 59 58 59 59 59 58 59 58 59 58 58 59 59 58 59 59 59 59 59 58 58 58 58 58 59 41 41 42 59 59 59 58 59 58 59 59 59 59 56 56 56 54 56 56 56 59 58 59 58 58 58 59 58 59 58 59 58 59 59 59 58 59 58 59 40 4 40 41 42 58 59 58 59 58 59 58 59 58 59 58 59 58 59
58 59 59 59 58 59 58 58 58 58 59 59 59 58 59 58 59 58 58 59 58 59 59 59 58 58 58 59 58 59 59 58 59 58 59 59 59 58 59 59 41 58 59 59 58 58 58 59 59 59 56 56 56 56 56 41 42 41 40 42 15 40 56 56 56 56 15 41 41 15 58 59 59 58 59 58 58 58 58 59 58 41 4 41 40 15 58 59 58 59 58 59 58 59 58 59 58 59 58 58
59 43 40 43 41 15 41 15 41 43 43 40 41 40 42 40 41 40 43 42 42 41 40 15 15 43 41 40 41 42 43 42 41 40 40 15 15 15 43 41 43 43 43 41 42 40 43 15 40 43 15 15 15 42 43 40 40 42 41 40 40 41 41 15 40 42 15 40 15 43 59 58 58 59 58 59 59 58 59 58 59 15 4 15 41 40 58 59 58 59 58 59 58 59 58 59 58 59 58 58
59 43 15 40 15 15 40 41 40 42 41 43 40 41 43 43 42 42 40 15 40 43 41 15 42 15 40 40 15 42 42 43 40 15 41 41 41 15 40 40 43 15 41 40 15 43 15 42 40 15 15 42 43 41 15 42 42 43 41 42 15 40 40 15 43 42 40 43 43 15 58 59 58 58 59 58 59 58 58 58 59 41 4 40 41 42 58 59 58 59 58 59 58 59 58 59 58 59 58 59
59 41 40 40 40 41 42 43 41 42 42 41 40 43 42 42 40 43 40 43 41 43 15 43 15 42 40 40 43 40 40 42 15 43 43 41 41 41 41 42 42 40 40 40 43 15 42 41 42 41 43 42 42 43 40 42 43 41 15 41 40 41 40 41 41 41 43 15 40 41 59 58 58 58 58 58 58 58 58 59 58 42 4 42 43 42 58 59 58 59 58 59 58 59 58 59 58 59 58 59
59 40 41 42 43 43 41 15 42 41 43 43 42 40 43 15 15 40 42 40 42 40 40 41 40 43 42 41 41 40 40 15 40 42 40 42 15 43 41 43 40 42 43 41 15 15 40 41 15 40 42 42 40 40 41 42 41 15 43 42 41 43 43 41 41 15 40 42 42 15 41 43 41 15 43 40 15 58 59 58 43 43 4 42 41 41 58 59 58 59 58 59 58 59 58 59 58 59 58 59
59 42 43 40 15 41 41 40 40 15 15 40 40 43 43 40 15 42 40 41 42 41 42 43 41 15 15 42 43 15 42 40 42 41 43 43 41 15 43 43 40 42 40 15 42 40 41 41 43 42 41 43 40 15 40 42 41 43 40 42 43 40 15 41 43 15 40 43 40 43 41 43 41 40 43 15 41 58 59 58 15 42 4 40 43 41 43 42 40 15 42 43 43 15 42 43 42 15 43 58
59 40 15 43 40 15 40 40 41 15 41 42 43 40 15 40 41 40 15 15 41 40 42 43 15 41 42 42 15 42 15 43 40 15 15 43 41 15 41 41 15 43 42 15 15 40 43 43 43 43 43 40 41 41 42 43 42 15 41 15 41 15 40 42 43 43 41 42 41 43 41 43 40 41 40 43 43 58 59 58 42 41 4 40 42 40 42 42 42 15 40 40 40 41 43 41 40 42 42 59
59 42 41 15 42 43 43 15 43 15 41 15 43 15 15 15 15 42 43 43 41 41 40 15 41 41 15 42 41 42 42 41 40 42 42 15 43 43 40 42 41 43 42 43 43 40 41 15 42 42 43 43 42 42 15 40 43 40 41 40 15 42 42 43 42 15 41 41 15 42 43 41 41 43 42 43 43 58 59 58 15 15 4 4 4 4 4 4 4 4 42 42 15 41 15 41 43 41 15 58
59 40 15 43 40 40 41 15 43 42 41 43 40 41 43 41 40 41 41 15 40 43 41 15 15 15 15 42 41 43 41 43 42 42 40 15 15 41 15 43 42 40 40 15 41 41 15 41 40 40 43 43 41 43 15 43 15 15 40 40 43 40 15 43 41 42 41 40 15 15 15 41 41 41 43 41 15 58 59 58 41 43 41 40 42 15 41 42 42 15 43 43 41 40 40 15 15 43 40 58
58 41 43 15 15 15 15 40 41 41 41 42 43 41 42 43 15 41 41 40 40 40 41 15 41 42 41 41 43 43 41 15 42 15 15 42 15 15 40 43 40 43 40 15 40 15 42 40 41 42 41 43 40 41 42 43 43 42 15 41 41 42 40 43 43 42 41 43 15 15 40 40 41 42 41 15 43 58 59 58 40 43 42 42 43 15 43 42 40 43 15 15 40 42 41 41 41 15 15 59
58 40 42 43 43 15 41 41 40 40 43 41 42 43 42 42 43 42 43 40 43 43 41 43 42 15 41 40 42 40 40 41 40 41 15 40 41 42 40 15 43 41 43 15 43 42 15 15 41 15 41 15 41 42 43 42 40 15 41 41 43 41 40 41 42 15 40 41 40 15 40 42 41 41 41 42 41 58 59 58 59 58 59 58 59 58 59 58 59 58 59 58 59 58 59 58 59 58 59 59
59 43 40 41 40 15 42 15 43 40 42 40 15 41 15 43 40 15 43 42 43 40 41 15 41 40 40 15 40 15 42 43 42 41 41 43 41 43 43 43 41 43 42 15 43 15 43 42 42 43 40 43 42 15 15 43 41 41 42 15 41 41 15 42 40 15 15 15 15 41 40 41 43 43 41 43 41 58 59 58 59 58 59 58 59 58 59 58 59 58 59 58 59 58 59 58 59 58 59 58
58 43 43 43 40 42 40 40 40 43 15 41 42 43 41 42 42 41 43 43 40 15 40 40 15 42 43 15 40 40 43 15 40 42 41 42 15 15 15 40 42 15 15 42 41 41 42 42 41 41 43 40 43 42 40 41 43 40 15 43 41 41 43 43 40 41 43 41 43 40 42 43 15 40 15 43 40 58 59 58 59 58 59 58 59 58 59 58 59 58 59 58 59 58 59 58 59 58 59 59
58 15 42 40 41 41 41 15 40 41 42 40 41 42 40 40 41 42 42 41 42 41 43 42 43 40 15 40 43 40 42 40 40 40 42 42 42 15 42 40 15 40 41 15 41 40 15 42 43 40 41 41 42 15 43 15 41 40 41 41 43 41 41 42 40 41 40 41 41 43 43 42 41 15 41 43 15 58 59 58 59 58 59 58 59 58 59 58 59 58 59 58 59 58 59 58 59 58 59 59
59 41 41 40 40 40 15 41 41 15 41 15 15 41 43 42 42 41 41 40 43 42 43 42 42 15 40 40 15 41 43 43 15 43 15 41 42 41 41 40 40 15 42 41 42 40 43 43 15 42 15 43 40 15 43 41 43 40 40 41 43 40 15 42 42 40 42 15 41 42 42 15 15 41 42 43 41 58 59 58 59 58 59 58 59 58 59 58 59 58 59 58 59 58 59 58 59 58 59 58
59 15 40 42 43 43 41 15 42 40 42 15 40 43 43 43 40 43 43 41 15 15 41 42 43 41 41 41 15 40 43 43 41 15 40 15 41 15 43 43 40 43 41 43 41 40 41 43 40 40 40 40 42 42 43 41 41 43 40 42 15 15 43 40 41 15 42 15 41 41 40 40 15 42 40 15 43 41 43 42 43 41 42 15 15 15 15 15 41 40 42 15 43 40 15 42 43 41 40 59
59 15 41 15 40 40 40 42 40 42 42 43 40 15 43 43 40 40 43 41 41 40 43 41 42 43 40 42 15 15 40 15 41 15 42 42 43 15 15 15 43 42 43 43 15 43 42 41 43 43 43 15 40 40 43 41 40 40 15 15 42 15 43 43 15 43 15 43 40 43 41 40 15 42 40 43 15 43 43 42 43 15 41 40 41 40 15 43 41 40 15 43 41 43 15 40 42 15 43 59
59 43 15 41 15 42 42 43 15 41 41 40 43 41 40 43 41 15 41 41 43 41 42 41 42 40 43 43 42 15 41 42 15 43 15 40 41 43 43 42 40 42 15 43 43 41 15 43 42 41 43 41 42 15 43 43 40 15 15 15 40 40 43 43 15 43 43 43 40 42 42 43 40 41 15 40 15 15 42 43 43 42 43 40 40 40 15 42 43 43 15 43 15 42 42 41 42 43 43 59
59 40 15 43 43 43 43 42 41 41 15 42 40 15 40 15 15 43 42 15 42 42 15 43 43 40 42 40 42 42 40 42 40 41 42 41 42 40 15 40 41 41 43 43 40 15 40 40 15 41 43 42 42 42 43 43 40 15 41 15 15 43 15 40 41 15 42 40 42 41 41 15 41 15 15 43 43 42 15 43 43 43 43 40 15 15 41 42 41 41 41 15 42 43 42 15 43 40 42 58
58 40 40 42 41 40 41 15 40 15 41 42 42 42 15 43 42 42 41 43 42 41 15 40 42 42 41 42 42 43 15 40 43 42 15 41 43 43 42 40 15 15 40 43 40 42 40 42 43 42 41 43 40 41 15 15 42 42 40 15 43 41 42 42 40 15 40 41 41 40 42 40 43 43 15 41 42 15 15 15 15 42 41 43 43 41 41 15 42 42 43 43 43 43 40 41 43 42 42 58
59 41 43 15 40 43 42 41 43 42 15 42 15 43 41 40 43 43 40 42 15 42 42 42 40 42 43 43 15 42 40 40 40 42 41 42 41 15 42 43 40 40 43 15 15 40 15 41 15 42 15 15 43 43 41 40 15 41 40 42 15 43 15 40 15 15 42 40 40 42 41 15 42 41 42 43 15 41 42 43 42 40 15 15 43 40 42 41 15 15 15 40 43 41 41 41 15 42 15 59
59 40 15 41 15 15 43 42 41 15 40 42 41 42 41 43 42 43 40 15 40 42 43 42 15 40 40 42 42 42 15 43 42 15 40 42 40 42 15 40 40 43 41 43 40 40 42 40 41 42 42 41 42 42 42 42 41 15 15 40 40 41 41 15 40 41 40 41 43 15 43 40 43 15 42 41 40 40 42 15 41 40 42 42 40 42 40 41 15 42 40 41 40 43 41 41 41 42 42 59
58 41 41 40 41 41 43 40 41 40 40 41 43 41 42 40 40 15 41 41 40 15 43 15 42 42 42 42 40 15 41 40 40 42 15 40 15 40 40 41 15 42 43 40 42 41 41 40 41 42 15 41 40 15 43 41 43 42 40 15 40 42 43 15 42 15 43 15 40 43 43 40 15 43 41 43 15 40 43 41 42 43 42 40 41 40 15 15 40 42 41 40 42 42 15 41 42 15 15 58
58 40 40 43 43 43 41 42 43 15 42 41 40 41 42 40 41 15 40 40 15 40 40 41 40 43 43 15 41 43 40 43 15 15 41 15 41 43 41 42 40 42 40 40 40 15 43 41 42 42 40 42 43 15 41 42 43 15 40 41 15 15 40 42 40 41 40 41 42 15 15 42 42 15 42 41 41 40 42 42 43 42 43 40 15 41 15 41 43 42 15 41 41 42 40 41 40 15 40 58
58 40 41 40 40 43 40 42 42 15 15 42 41 40 15 40 43 15 42 43 42 42 42 40 40 40 40 40 43 40 43 43 40 41 41 40 41 41 41 41 41 40 41 40 42 43 41 40 42 41 41 43 15 15 41 15 42 40 15 41 43 42 43 42 42 41 15 42 43 15 41 42 42 15 41 15 42 42 15 40 43 41 42 15 15 41 42 40 41 42 40 15 41 43 41 40 42 41 41 58
58 42 15 43 41 43 41 15 41 41 43 15 40 15 42 41 43 42 15 40 15 43 40 43 40 40 41 41 42 41 15 40 15 43 43 15 40 43 40 15 43 40 15 15 40 43 42 43 40 15 15 40 41 15 42 15 41 40 41 40 43 43 42 42 15 15 43 40 40 15 15 43 43 41 15 40 41 42 43 41 42 41 43 40 40 40 15 40 41 41 41 41 15 41 15 43 15 41 43 58
58 43 43 42 40 41 43 15 43 15 43 40 42 43 41 42 43 15 41 15 15 15 41 41 42 41 41 43 40 43 41 41 43 40 42 42 42 43 42 42 43 41 40 42 42 42 15 41 41 40 42 15 40 43 43 42 42 43 40 41 15 40 43 40 43 15 40 15 43 15 15 42 42 15 41 40 43 42 40 15 15 15 15 40 15 42 15 15 15 41 41 15 42 42 41 15 40 42 43 59
58 41 40 43 41 41 43 40 42 40 15 42 41 15 40 15 15 42 40 15 15 41 42 41 42 42 41 42 40 43 42 43 43 40 43 41 42 41 41 40 42 40 43 42 43 42 40 43 40 42 41 15 41 43 43 42 15 42 40 42 40 15 43 41 40 40 43 40 15 42 15 15 40 15 40 41 40 40 15 15 41 43 40 43 43 40 15 40 42 42 42 40 43 41 42 43 43 41 43 59
58 41 41 15 15 42 41 15 42 43 40 43 43 42 42 43 42 43 42 43 43 43 15 41 15 42 41 43 40 40 15 41 40 42 42 41 41 40 15 15 42 40 41 42 42 40 40 42 40 42 41 41 43 41 43 43 42 40 42 41 40 41 40 15 41 43 15 41 15 41 15 15 41 41 42 40 40 43 40 40 41 40 41 42 41 15 40 40 40 43 43 43 43 42 42 15 42 40 42 59
59 41 43 43 41 15 42 41 40 15 40 15 15 40 42 40 43 41 40 43 40 15 43 41 42 41 41 40 41 43 43 42 42 41 15 15 41 43 41 40 42 40 40 40 43 15 43 43 40 15 41 40 42 40 41 42 40 41 15 42 41 40 42 41 41 42 42 15 42 40 41 42 43 43 43 15 15 42 15 15 15 15 43 43 15 42 43 15 15 43 15 42 43 40 40 40 41 40 42 58
58 15 41 41 15 40 15 15 42 42 42 41 41 42 15 43 40 41 42 15 15 41 40 43 41 43 41 40 41 40 42 41 43 40 43 41 42 15 41 15 42 42 42 15 43 40 40 40 42 43 40 41 42 43 40 40 42 43 42 40 40 41 40 42 15 41 42 40 40 42 15 40 43 43 42 43 40 43 43 43 40 43 43 43 42 41 43 40 15 41 41 43 43 15 43 15 43 43 40 59
58 40 40 40 42 15 43 43 41 42 40 42 41 43 40 43 15 42 41 42 42 42 15 15 41 40 42 43 41 40 15 40 40 43 40 15 40 15 15 42 42 42 43 43 40 41 40 43 41 15 40 42 43 43 15 15 40 42 40 40 41 41 41 43 41 15 15 41 41 42 15 15 43 41 15 40 15 41 41 43 42 40 43 42 42 40 43 40 43 41 41 41 15 41 43 42 43 42 42 59
58 41 41 43 41 42 40 43 15 42 43 15 15 42 41 43 15 40 41 42 41 41 15 43 40 15 43 42 43 43 41 40 40 15 15 40 15 15 15 41 40 15 41 42 40 15 40 15 15 42 41 15 41 15 41 41 42 42 15 41 41 41 41 15 41 43 40 43 15 42 42 41 41 41 41 15 41 40 42 41 43 15 42 40 41 41 15 43 40 40 43 15 41 15 15 40 43 42 41 58
58 43 40 43 41 42 42 43 15 41 41 41 43 40 42 15 43 43 41 42 41 41 42 43 43 43 42 41 15 40 15 15 15 40 40 41 42 41 41 40 43 40 40 41 42 42 40 43 43 41 42 43 42 42 40 41 15 40 41 41 41 42 43 41 40 15 40 40 41 40 41 42 41 42 41 40 15 40 41 43 15 41 43 15 43 43 42 41 42 40 42 15 41 15 41 43 40 42 43 58
59 43 43 41 41 42 41 43 42 42 42 41 15 42 43 42 43 42 40 40 43 15 40 40 41 15 40 15 40 42 42 43 43 43 15 40 41 40 41 40 43 40 41 43 43 15 43 43 40 40 41 40 40 42 43 43 15 40 40 15 43 41 42 15 40 43 41 41 41 15 42 15 42 41 42 43 40 42 42 40 15 40 15 15 42 15 43 41 43 40 41 15 15 42 40 42 43 42 42 58
59 42 43 40 41 40 42 40 42 15 41 15 40 43 15 41 42 42 15 43 42 15 41 40 15 42 40 15 40 40 42 41 15 41 40 40 41 15 43 40 15 42 42 43 40 42 42 42 42 43 41 40 40 40 40 43 15 40 42 40 15 15 42 43 43 41 42 41 41 40 40 42 41 43 15 15 15 41 40 42 42 15 15 41 41 42 15 15 41 42 42 42 42 42 43 40 43 15 40 58
59 43 41 15 15 15 42 15 15 40 15 43 40 40 42 43 43 15 43 42 43 43 41 43 40 42 42 42 41 42 42 15 15 15 41 15 15 43 42 15 41 42 43 15 40 43 40 42 15 41 41 43 42 15 43 40 40 43 40 41 41 40 15 15 42 43 40 40 40 41 15 15 42 42 40 41 40 42 40 15 41 41 42 41 41 15 41 15 43 43 42 40 41 40 42 15 40 15 42 58
59 41 15 43 15 43 43 43 42 40 43 42 41 43 41 41 41 42 41 41 42 40 41 42 40 43 41 43 15 15 43 43 42 41 15 40 41 43 41 15 43 41 15 15 41 43 40 15 40 15 42 43 43 41 40 40 42 40 41 40 41 40 41 41 15 41 43 43 15 40 40 15 40 41 41 41 43 41 43 41 40 40 43 43 42 41 42 42 40 42 43 43 42 40 43 15 15 41 41 59
59 40 41 42 15 41 43 42 43 40 43 42 41 41 42 40 41 41 41 41 15 43 15 41 41 40 41 41 43 43 40 43 42 43 43 43 43 40 15 40 41 41 43 42 40 43 40 41 15 15 41 15 42 42 42 43 43 15 41 41 43 15 43 43 43 40 40 15 41 43 41 40 15 40 15 40 41 40 15 42 43 41 15 41 15 43 15 42 42 43 42 40 40 42 43 15 40 42 15 58
58 41 40 40 43 41 41 15 15 15 43 43 15 40 43 40 41 40 15 43 41 42 43 43 41 43 42 41 41 43 15 42 42 40 15 15 15 40 42 41 40 43 41 43 40 41 15 43 42 40 42 40 43 42 43 43 42 15 42 40 42 42 42 43 40 42 42 43 15 42 42 40 42 43 42 42 42 40 42 15 15 15 43 43 15 15 42 41 43 43 40 42 15 40 15 15 43 40 42 58
58 40 42 41 43 15 41 41 42 41 15 15 42 43 40 41 43 41 40 40 42 43 42 40 15 41 43 41 43 43 15 15 41 41 40 40 42 42 43 41 42 43 43 40 43 43 41 42 40 42 40 42 42 15 41 42 43 42 43 15 43 42 43 42 42 42 42 43 15 42 41 40 40 41 41 42 41 40 43 15 41 42 43 42 40 43 15 15 43 15 40 40 42 15 41 41 43 43 40 59
59 41 43 40 42 41 42 40 15 40 43 40 15 43 42 15 15 42 43 41 41 41 41 41 41 41 43 41 43 41 43 15 41 42 43 42 41 40 40 42 43 43 41 40 42 40 40 42 42 41 41 41 40 15 41 42 15 43 43 40 41 40 40 15 42 42 41 41 41 43 43 41 43 15 43 40 42 15 40 41 42 42 41 15 41 40 41 43 41 42 40 43 41 42 43 42 40 41 40 58
59 15 43 43 15 43 43 42 15 42 41 43 42 42 15 42 15 41 42 40 42 41 40 40 42 43 43 41 43 43 40 42 42 15 15 40 15 41 42 15 40 42 43 40 15 40 43 43 43 43 41 41 40 41 42 42 40 15 43 40 42 42 40 15 40 42 43 15 42 41 41 40 42 40 40 42 40 43 40 40 41 15 42 15 42 41 43 42 41 42 15 42 41 42 15 42 15 43 42 58
59 41 41 41 40 43 43 43 43 40 41 43 40 40 15 42 15 41 41 41 15 43 42 40 40 41 15 41 42 15 42 43 41 15 43 15 15 42 42 15 15 40 42 41 41 15 42 42 41 15 15 43 40 43 15 43 15 42 43 41 15 41 41 40 40 43 40 43 40 41 43 40 41 15 43 42 43 40 43 15 15 42 15 43 43 42 40 15 41 15 15 42 40 43 42 15 43 15 41 58
59 43 40 42 43 43 43 41 42 41 43 43 42 42 41 40 15 41 40 40 42 41 40 15 42 41 41 40 43 15 42 40 41 43 42 42 41 42 40 41 43 15 42 42 42 40 43 43 40 40 15 43 41 40 41 42 43 43 43 40 42 41 41 40 40 40 40 40 40 43 41 42 15 41 40 42 40 41 15 41 15 43 40 41 42 42 40 43 41 15 43 42 15 43 15 43 43 43 42 59
59 41 41 40 40 15 40 40 40 40 42 41 41 41 41 42 40 15 40 41 41 41 42 40 41 43 41 40 40 15 41 41 42 42 43 15 42 42 40 42 43 42 15 41 41 42 43 15 43 15 43 42 42 42 40 42 43 15 41 42 43 42 42 15 42 41 41 42 42 42 42 43 42 40 40 43 41 40 43 15 15 42 43 15 15 41 43 40 40 43 41 15 41 42 43 43 41 42 41 58
58 42 42 15 43 43 43 41 43 43 41 40 40 41 41 43 42 41 42 15 41 40 43 40 40 15 42 40 43 15 15 41 43 43 15 15 42 42 41 15 40 15 42 40 15 15 43 41 15 42 42 15 41 43 42 43 42 41 42 15 42 41 42 40 42 15 41 40 41 43 41 42 42 15 40 41 43 43 43 43 41 43 43 42 42 42 15 15 40 40 42 42 43 42 41 40 43 41 41 58
59 43 43 40 41 42 41 41 42 42 40 15 41 43 40 43 41 42 42 41 40 41 15 40 40 40 42 43 43 42 42 42 41 43 43 15 41 40 42 40 42 41 41 15 15 40 43 15 40 15 42 41 42 41 41 15 40 41 42 42 42 43 40 40 40 43 41 41 15 43 41 15 41 41 43 42 42 15 41 41 42 15 42 40 41 42 43 42 40 40 43 41 43 40 41 40 43 15 40 58
58 40 40 42 42 40 40 40 42 15 42 42 42 42 42 43 42 41 43 15 40 15 15 41 41 42 40 40 42 41 42 40 40 40 15 15 43 41 43 40 43 40 40 42 41 40 43 40 15 43 15 41 41 41 42 40 41 15 41 15 42 15 15 43 42 43 42 15 41 40 41 43 15 15 41 41 15 15 41 42 43 15 42 42 43 15 43 15 42 43 40 40 41 15 42 42 42 41 43 58
58 41 41 15 43 41 42 42 42 15 40 15 40 40 40 43 41 42 40 40 42 42 43 41 42 41 43 40 42 40 40 42 15 40 41 43 43 41 43 42 42 42 15 15 40 42 43 42 42 42 41 40 40 15 43 43 41 40 15 42 42 15 43 42 43 42 15 41 40 42 41 40 40 15 42 41 40 43 40 42 15 43 40 40 43 15 41 43 43 42 43 41 43 40 42 43 43 40 41 59
58 43 15 43 40 15 40 43 40 42 43 41 43 43 43 43 40 40 42 42 41 40 41 41 40 15 41 42 42 40 42 15 43 40 42 42 40 42 42 42 42 15 42 41 42 43 42 42 42 15 42 15 42 43 42 41 43 40 43 43 41 40 43 43 15 40 42 42 40 41 15 40 41 41 15 15 42 43 15 43 41 15 41 15 43 41 40 43 43 41 40 15 43 40 42 42 43 42 15 59
58 42 42 40 15 15 40 41 43 42 40 15 15 42 43 42 40 43 41 41 41 15 42 15 42 15 42 15 40 15 43 42 43 40 42 40 15 41 40 43 40 42 40 41 43 42 43 40 43 40 42 41 41 41 43 40 43 41 43 15 41 40 40 15 40 43 42 15 15 41 40 15 41 41 42 42 40 15 42 42 43 43 40 41 40 41 42 42 41 40 41 41 40 15 41 40 41 42 42 58
59 15 42 42 41 43 43 43 41 42 43 43 41 15 42 15 41 43 41 41 43 41 41 42 43 43 41 43 41 41 15 43 40 40 43 42 41 41 43 43 40 15 15 43 40 15 41 15 42 41 40 42 43 40 43 41 40 41 43 15 42 15 43 42 43 15 40 15 42 15 42 15 15 41 40 43 43 43 42 15 41 43 41 41 43 41 41 15 41 43 40 40 40 41 41 41 41 41 43 58
58 42 40 40 15 43 15 40 42 43 43 43 40 43 40 40 40 15 15 40 43 41 40 15 43 41 43 41 42 41 43 42 41 40 42 43 43 40 42 41 15 42 40 43 15 40 43 41 42 15 15 42 43 41 43 41 41 40 43 41 41 42 42 43 42 41 43 41 41 41 40 41 40 40 43 42 43 41 41 15 42 42 43 42 42 43 41 40 43 43 40 40 40 41 15 41 43 42 40 59
58 43 43 40 15 15 42 40 41 15 40 15 15 15 43 42 42 40 41 43 42 43 43 15 43 41 15 42 42 15 40 42 41 40 40 40 42 40 42 42 15 15 42 42 15 15 43 15 43 41 40 43 41 41 42 42 40 42 42 43 42 15 15 43 42 15 43 42 41 40 15 15 15 40 41 41 42 40 42 15 15 15 40 42 41 43 15 40 43 40 40 15 42 42 15 42 15 42 42 58
58 43 15 42 40 41 42 15 15 40 42 43 41 43 15 43 40 43 43 42 41 15 41 40 42 15 42 40 42 15 40 40 43 41 41 40 15 43 15 40 43 42 42 42 40 43 40 42 43 41 43 15 41 42 40 42 41 42 41 41 15 43 43 40 42 41 43 40 15 41 15 41 15 41 43 43 15 42 42 42 15 43 43 43 42 40 43 15 42 40 40 40 43 42 15 41 15 43 43 59
58 15 43 41 41 42 15 40 40 41 41 42 40 43 40 15 41 41 41 42 40 42 41 40 40 41 42 42 40 15 40 40 40 43 40 43 15 41 43 40 40 43 40 43 42 40 43 40 42 40 15 43 43 41 41 42 43 42 40 42 43 43 43 15 42 43 40 40 15 41 43 41 42 40 40 41 40 42 40 42 40 42 42 42 41 43 42 15 15 42 41 42 40 41 15 41 41 40 40 59
59 43 42 43 43 42 40 40 40 42 15 15 41 41 40 43 40 15 15 42 15 42 42 42 41 41 42 41 41 42 42 41 40 42 40 43 42 15 15 15 42 42 42 15 43 42 40 42 41 15 15 40 40 40 40 43 15 41 15 15 41 40 15 40 40 41 43 43 41 42 15 43 41 15 15 42 42 43 42 40 43 41 40 40 15 15 15 15 42 43 41 42 40 42 43 15 43 40 42 58
58 41 40 41 15 41 15 15 41 40 41 43 42 41 15 43 43 15 40 43 41 15 41 42 42 41 41 40 15 15 40 40 15 41 40 42 42 40 41 41 41 43 41 43 43 40 40 41 40 42 15 42 41 41 15 15 42 43 40 40 43 41 15 40 43 42 42 40 43 43 43 40 42 41 41 40 41 42 42 42 42 41 40 40 43 15 41 41 42 40 15 41 43 40 41 43 40 41 43 58
58 43 43 40 41 42 41 15 42 42 41 41 15 40 40 15 42 43 43 43 43 41 15 15 43 43 15 40 42 40 15 15 41 15 42 43 42 42 42 42 43 43 43 40 15 15 40 42 41 40 15 42 43 15 41 41 40 41 40 15 43 42 15 40 41 43 40 40 40 41 40 41 41 42 43 40 42 43 40 40 41 40 40 43 42 42 43 43 42 42 15 41 43 43 41 41 42 43 15 58
58 58 58 59 58 59 58 58 59 59 58 58 59 58 58 58 59 59 58 59 58 59 58 58 58 58 59 59 58 59 59 58 58 58 59 58 59 59 58 58 59 59 58 59 59 58 58 58 58 58 58 58 58 58 59 58 59 58 59 59 59 58 59 58 59 59 58 59 58 58 58 59 58 58 58 58 58 58 58 58 59 59 59 59 59 58 58 59 59 59 58 59 59 59 59 58 59 58 59 59